0,NEP_Mutation,input1,input2,output1,output2,input,output1_RF,output2_RF,average_RF
1,M1K,0,0,0,1,0,0.229927726,0.603094931,0.416511329
1,M1R,0,0,0,1,0,0.229927726,0.603094931,0.416511329
1,M1L,0,0,1,0,0,0.530957722,0.302064936,0.416511329
1,M1T,0,2,1,2,2,0.053836467,0.302064936,0.177950701
1,M1V,3,4,1,15,7,-0.372132265,0.603094931,0.115481333
1,M1I,2,3,0,10,5,-0.548223524,0.56530637,0.008541423
2,D2R,55,43,131,301,98,0.354866463,0.786436684,0.570651573
2,D2K,16,22,56,68,38,0.394737975,0.549849419,0.472293697
2,D2_,17,25,20,180,42,-0.081321435,0.926275055,0.42247681
2,D2Q,14,13,49,27,27,0.481739699,0.302064936,0.391902317
2,D2N,13,11,37,20,24,0.411771314,0.226344222,0.319057768
2,D2V,50,36,116,78,86,0.358594335,0.260172774,0.309383555
2,D2W,19,24,75,29,43,0.467288642,0.135733514,0.301511078
2,D2F,15,16,43,26,31,0.368230424,0.228278722,0.298254573
2,D2M,20,19,39,36,39,0.229927726,0.268206668,0.249067197
2,D2Y,17,14,40,21,31,0.337561605,0.139337638,0.238449621
2,D2P,20,20,36,37,40,0.185345594,0.269064676,0.227205135
2,D2L,54,76,118,91,130,0.188203392,0.148581467,0.16839243
2,D2A,30,34,62,41,64,0.216354919,0.112400869,0.164377894
2,D2G,36,37,73,44,73,0.229927726,0.08604573,0.157986728
2,D2I,15,20,17,25,35,-0.071102269,0.160735783,0.044816757
2,D2C,27,26,25,38,53,-0.087492686,0.160735783,0.036621549
2,D2T,27,37,43,32,64,0.060467046,0.007665519,0.034066282
2,D2H,10,17,29,7,27,0.25989095,-0.242003109,0.00894392
2,D2E,25,32,29,23,57,-0.056379013,-0.081151816,-0.068765414
2,D2S,39,52,37,39,91,-0.154076505,-0.0596629,-0.106869702
3,P3A,35,29,548,32,64,1.156586714,0.007665519,0.582126116
3,P3K,15,14,58,56,29,0.523658483,0.580818537,0.55223851
3,P3R,50,76,123,124,126,0.21954569,0.295171228,0.257358459
3,P3M,13,16,37,14,29,0.332590068,0.00103494,0.166812504
3,P3V,37,46,32,110,83,-0.17583762,0.423108628,0.123635504
3,P3S,36,39,75,24,75,0.229927726,-0.180808648,0.024559539
3,P3Q,14,20,17,20,34,-0.058867813,0.080216186,0.010674187
3,P3T,24,38,64,14,62,0.243500533,-0.321184355,-0.038841911
3,P3C,18,17,16,17,35,-0.095925853,0.00103494,-0.047445457
3,P3W,18,17,15,14,35,-0.122254792,-0.078146306,-0.100200549
3,P3G,67,59,64,41,126,-0.060962638,-0.178489495,-0.119726066
3,P3L,43,56,40,38,99,-0.157288417,-0.106870457,-0.132079437
3,P3Y,13,21,8,14,34,-0.359897809,-0.06591185,-0.212904829
3,P3H,12,11,9,4,23,-0.150283516,-0.379176302,-0.264729909
3,P3N,21,19,10,11,40,-0.341463445,-0.231537675,-0.28650056
3,P3F,13,11,7,5,24,-0.264922296,-0.317723823,-0.291323059
3,P3_,18,23,4,21,41,-0.69435156,0.021238326,-0.336556617
3,P3I,21,18,11,4,39,-0.292951019,-0.601025051,-0.446988035
3,P3E,20,30,2,18,50,-1.000521195,-0.126751639,-0.563636417
3,P3D,20,31,2,7,51,-1.008954363,-0.510848421,-0.759901392
4,N4K,7,21,41,35,28,0.390779019,0.395969439,0.393374229
4,N4P,19,30,55,43,49,0.279145749,0.246547608,0.262846678
4,N4W,21,10,31,27,31,0.229927726,0.244072989,0.237000357
4,N4A,25,25,38,34,50,0.113422157,0.138562804,0.125992481
4,N4V,31,51,50,69,82,0.01841981,0.228084883,0.123252347
4,N4H,12,13,28,11,25,0.277352376,-0.033727166,0.121812605
4,N4I,16,15,18,23,31,0.003531349,0.177126199,0.090328774
4,N4L,44,35,38,69,79,-0.082097654,0.244072989,0.080987667
4,N4S,50,43,51,57,93,-0.027196784,0.092365076,0.032584146
4,N4R,56,47,56,52,103,-0.031230757,0.009307466,-0.010961646
4,N4F,16,25,23,19,41,-0.013110323,-0.020154359,-0.016632341
4,N4_,10,19,18,11,29,0.031560072,-0.095875073,-0.0321575
4,N4Y,14,21,21,12,35,0.016047906,-0.140294213,-0.062123153
4,N4G,35,54,33,34,89,-0.192835866,-0.108109529,-0.150472698
4,N4Q,16,11,5,13,27,-0.439079055,0.00103494,-0.219022057
4,N4T,19,29,14,16,48,-0.284177095,-0.157682223,-0.220929659
4,N4M,15,25,16,9,40,-0.152407209,-0.310718921,-0.231563065
4,N4E,21,17,8,11,38,-0.406894371,-0.209818425,-0.308356398
4,N4C,30,19,8,14,49,-0.514799769,-0.22081381,-0.367806789
4,N4D,26,22,3,13,48,-0.858208363,-0.242003109,-0.550105736
5,T5K,15,19,100,52,34,0.690181056,0.482272761,0.586226908
5,T5R,37,57,105,136,94,0.277509986,0.461061898,0.369285942
5,T5P,19,23,24,48,42,-0.005600721,0.35879256,0.17659592
5,T5N,19,20,43,17,39,0.271320411,-0.044722551,0.11329893
5,T5H,14,18,20,20,32,0.033633081,0.105770291,0.069701686
5,T5M,13,16,26,12,29,0.184170236,-0.061112967,0.061528634
5,T5G,42,36,48,46,78,0.022496715,0.076535702,0.049516209
5,T5W,18,22,18,22,40,-0.10410253,0.051008915,-0.026546807
5,T5S,31,35,44,24,66,0.057065437,-0.126069858,-0.034502211
5,T5I,17,15,18,11,32,-0.009832613,-0.137267758,-0.073550185
5,T5_,16,18,27,8,34,0.133017713,-0.287760599,-0.077371443
5,T5F,18,24,27,12,42,0.043617302,-0.217460168,-0.086921433
5,T5Q,20,17,11,22,37,-0.270674624,0.084009175,-0.093332725
5,T5Y,17,20,19,10,37,-0.048825875,-0.236325976,-0.142575925
5,T5L,45,56,33,39,101,-0.247193529,-0.104475245,-0.175834387
5,T5V,54,37,36,27,91,-0.165658377,-0.21456486,-0.190111619
5,T5C,21,13,7,15,34,-0.411050331,-0.037883126,-0.224466729
5,T5A,28,35,17,17,63,-0.320979743,-0.248842533,-0.284911138
5,T5D,20,16,10,7,36,-0.296881313,-0.363046801,-0.329964057
5,T5E,23,21,14,7,44,-0.247193529,-0.448057591,-0.34762556
6,V6K,8,18,42,46,26,0.432032418,0.542799029,0.487415724
6,V6R,40,50,114,107,90,0.331584174,0.376447299,0.354015737
6,V6L,49,47,155,46,96,0.43628059,-0.012608941,0.211835825
6,V6P,15,18,24,32,33,0.096388818,0.289099959,0.192744388
6,V6A,32,30,65,37,62,0.250131112,0.082507983,0.166319548
6,V6W,20,17,26,24,37,0.081507894,0.120221348,0.100864621
6,V6T,10,20,22,15,30,0.100293868,0.014823225,0.057558546
6,V6I,21,17,18,23,38,-0.08238328,0.09121157,0.004414145
6,V6_,12,16,13,10,28,-0.086342236,-0.118940377,-0.102641307
6,V6F,15,17,21,8,32,0.053836467,-0.262206495,-0.104185014
6,V6E,8,18,15,7,26,0.002683945,-0.226208841,-0.111762448
6,V6D,15,23,29,5,38,0.115984374,-0.510848421,-0.197432024
6,V6N,21,15,15,9,36,-0.134154015,-0.266136788,-0.200145402
6,V6Q,14,18,8,13,32,-0.334343704,-0.070320968,-0.202332336
6,V6M,15,17,11,9,32,-0.209404968,-0.216449004,-0.212926986
6,V6G,43,51,20,39,94,-0.425576584,-0.073598678,-0.249587631
6,V6S,54,55,32,30,109,-0.292951019,-0.247966056,-0.270458537
6,V6H,12,17,8,7,29,-0.292951019,-0.271966332,-0.282458676
6,V6Y,15,21,21,3,36,0.004148683,-0.664076797,-0.329964057
6,V6C,18,21,9,6,39,-0.372132265,-0.454897016,-0.41351464
7,S7K,15,18,68,54,33,0.5372979,0.510948708,0.524123304
7,S7R,38,50,134,115,88,0.410871488,0.417132918,0.414002203
7,S7A,26,23,69,57,49,0.376055762,0.366522925,0.371289343
7,S7Q,10,17,24,42,27,0.180709704,0.48837536,0.334542532
7,S7W,21,19,29,49,40,0.094265124,0.388251083,0.241258104
7,S7P,17,20,40,22,37,0.262927986,0.084009175,0.173468581
7,S7M,17,24,18,55,41,-0.114567963,0.427003672,0.156217855
7,S7I,20,19,21,42,39,-0.029709584,0.3334734,0.151881908
7,S7C,7,25,35,16,32,0.267716287,0.013999917,0.140858102
7,S7V,37,43,53,58,80,0.053836467,0.164431928,0.109134198
7,S7H,14,14,6,55,28,-0.387372232,0.587854965,0.100241367
7,S7L,43,54,72,47,97,0.102024511,-0.007919903,0.047052304
7,S7_,13,20,9,29,33,-0.301551191,0.247707273,-0.026921959
7,S7F,18,27,13,36,45,-0.28670207,0.207508828,-0.039596621
7,S7Y,19,24,24,11,43,-0.015584942,-0.262206495,-0.138895718
7,S7T,21,26,17,16,47,-0.196041006,-0.14872738,-0.172384193
7,S7E,22,18,9,19,40,-0.382856131,-0.009688925,-0.196272528
7,S7N,15,16,9,10,31,-0.275222252,-0.161692357,-0.218457305
7,S7G,43,53,23,26,96,-0.376632766,-0.253343034,-0.3149879
7,S7D,16,20,3,9,36,-0.736214007,-0.266136788,-0.501175397
8,S8L,42,45,478,118,87,0.965780567,0.433129225,0.699454896
8,S8M,16,13,41,42,29,0.376055762,0.458412137,0.417233949
8,S8K,15,9,37,32,24,0.411771314,0.422638867,0.417205091
8,S8W,23,19,41,75,42,0.219708561,0.549410072,0.384559317
8,S8V,43,43,84,124,86,0.219827399,0.459455696,0.339641548
8,S8R,34,43,125,60,77,0.438203669,0.195300168,0.316751918
8,S8I,11,14,34,23,25,0.359022423,0.267302829,0.313162626
8,S8F,14,23,27,28,37,0.097302161,0.184679337,0.140990749
8,S8C,19,17,27,22,36,0.108884033,0.095591048,0.102237541
8,S8Y,19,19,13,46,38,-0.215008845,0.383098187,0.084044671
8,S8T,26,23,35,20,49,0.087260223,-0.074685774,0.006287224
8,S8G,40,47,40,34,87,-0.101771089,-0.098349692,-0.100060391
8,S8H,13,14,47,2,27,0.464010932,-0.667971841,-0.101980454
8,S8A,27,23,16,24,50,-0.247193529,-0.007565232,-0.12737938
8,S8N,17,15,9,14,32,-0.288586214,-0.040357745,-0.164471979
8,S8Q,22,15,31,5,37,0.155294108,-0.499567411,-0.172136651
8,S8_,10,15,7,8,25,-0.281955635,-0.158665903,-0.220310769
8,S8E,15,24,5,23,39,-0.593981015,0.080216186,-0.256882414
8,S8D,7,11,6,2,18,-0.203727835,-0.499567411,-0.351647623
8,S8P,16,22,3,5,38,-0.75907689,-0.510848421,-0.634962655
9,F9I,13,30,77,90,43,0.478569652,0.617653652,0.548111652
9,F9Y,10,21,42,52,31,0.358246203,0.521190827,0.439718515
9,F9V,56,43,165,133,99,0.450035814,0.429169734,0.439602774
9,F9L,48,58,187,111,106,0.474701798,0.321899181,0.398300489
9,F9M,23,22,48,48,45,0.257365975,0.329503184,0.293434579
9,F9H,2,0,1,4,2,0.053836467,0.523913685,0.288875076
9,F9T,39,29,81,44,68,0.304892488,0.116428359,0.210660423
9,F9R,61,52,96,99,113,0.159794609,0.245160084,0.202477347
9,F9S,38,58,75,88,96,0.123969584,0.264683208,0.194326396
9,F9Q,11,18,24,24,29,0.15074648,0.22288369,0.186815085
9,F9D,20,27,17,85,47,-0.196041006,0.55532215,0.179640572
9,F9C,27,18,35,29,45,0.123472395,0.116428359,0.119950377
9,F9A,32,35,35,43,67,-0.046278686,0.113008699,0.033365007
9,F9E,22,24,14,48,46,-0.266078873,0.320163158,0.027042143
9,F9K,14,17,8,25,31,-0.320979743,0.211888305,-0.054545719
9,F9G,59,43,62,30,102,0.016431051,-0.219410595,-0.101489772
9,F9_,24,26,21,17,50,-0.135219769,-0.150232735,-0.142726252
9,F9P,26,34,25,17,60,-0.140428761,-0.227992394,-0.184210578
9,F9W,21,22,17,12,43,-0.158252445,-0.227444388,-0.192848417
9,F9N,19,21,9,2,40,-0.382856131,-0.833597666,-0.608226898
10,Q10L,31,44,194,199,75,0.639148745,0.722281339,0.680715042
10,Q10V,30,40,111,182,70,0.4278874,0.713257677,0.570572538
10,Q10Y,9,18,33,49,27,0.314248612,0.553876909,0.43406276
10,Q10M,16,18,56,39,34,0.441734537,0.360056883,0.40089571
10,Q10P,21,17,75,36,38,0.519676711,0.279202053,0.399439382
10,Q10I,13,17,30,37,30,0.229927726,0.390486838,0.310207282
10,Q10K,19,14,29,28,33,0.175570064,0.232984017,0.20427704
10,Q10W,18,26,29,38,44,0.053836467,0.239917029,0.146876748
10,Q10R,70,69,83,88,139,0.008078977,0.105326907,0.056702942
10,Q10_,18,11,15,17,29,-0.043073546,0.080216186,0.01857132
10,Q10F,0,1,0,0,1,-0.071102269,0.00103494,-0.035033665
10,Q10A,29,26,22,31,55,-0.156532465,0.059026887,-0.048752789
10,Q10S,29,46,66,18,75,0.175188937,-0.299995056,-0.06240306
10,Q10T,33,37,26,23,70,-0.189966858,-0.168982171,-0.179474515
10,Q10E,15,23,20,3,38,-0.038917586,-0.68693968,-0.362928633
10,Q10G,40,49,21,17,89,-0.381892102,-0.396905069,-0.389398586
10,Q10H,18,24,8,9,42,-0.44929822,-0.33140352,-0.39035087
10,Q10N,19,21,6,7,40,-0.537758091,-0.407628934,-0.472693512
10,Q10C,10,20,6,3,30,-0.416335928,-0.587236767,-0.501786347
10,Q10D,18,15,1,1,33,-1.000521195,-0.928383986,-0.96445259
11,D11T,29,23,159,86,52,0.709771839,0.517308319,0.613540079
11,D11C,13,18,55,72,31,0.472965775,0.660237818,0.566601796
11,D11K,10,23,67,54,33,0.530957722,0.510948708,0.520953215
11,D11V,31,39,130,108,70,0.495940673,0.488233085,0.492086879
11,D11Q,5,13,35,26,18,0.507476626,0.454675099,0.481075862
11,D11S,30,46,125,125,76,0.443807546,0.515944756,0.479876151
11,D11Y,19,9,29,56,28,0.244650983,0.595541793,0.420096388
11,D11M,15,22,55,48,37,0.398332157,0.412477419,0.405404788
11,D11R,56,74,195,157,130,0.404912502,0.383450727,0.394181614
11,D11A,22,41,57,121,63,0.187175746,0.582244792,0.384710269
11,D11W,18,22,59,45,40,0.39529512,0.352038911,0.373667015
11,D11G,45,41,122,80,86,0.380313585,0.271030702,0.325672143
11,D11H,11,15,37,22,26,0.378347559,0.232429008,0.305388283
11,D11N,11,8,21,20,19,0.271320411,0.323254235,0.297287323
11,D11F,10,9,22,17,19,0.290625567,0.256307445,0.273466506
11,D11I,16,12,20,38,28,0.089749023,0.430731545,0.260240284
11,D11L,37,37,108,43,74,0.392292961,0.070456349,0.231374655
11,D11_,14,10,11,11,24,-0.088831036,-0.016693827,-0.052762432
11,D11E,14,20,11,17,34,-0.234959072,0.013269396,-0.110844838
11,D11P,24,26,31,9,50,0.027507528,-0.40550524,-0.188998856
12,I12F,20,15,54,31,35,0.413987915,0.250912413,0.332450164
12,I12A,14,20,31,29,34,0.19100966,0.235118146,0.213063903
12,I12K,12,16,29,19,28,0.244650983,0.140696933,0.192673958
12,I12R,31,31,43,59,62,0.074039853,0.280875637,0.177457745
12,I12E,9,16,11,31,25,-0.105864376,0.392241566,0.143188595
12,I12_,13,14,29,10,27,0.25989095,-0.10370041,0.07809527
12,I12S,29,33,36,32,62,-0.001211099,0.021238326,0.010013613
12,I12Y,11,14,9,12,25,-0.185045622,0.00103494,-0.092005341
12,I12G,31,38,38,23,69,-0.024105707,-0.162821863,-0.093463785
12,I12Q,9,5,6,5,14,-0.101065493,-0.095875073,-0.098470283
12,I12D,12,9,6,11,21,-0.267396915,0.038823501,-0.114286707
12,I12C,18,15,12,13,33,-0.187607839,-0.083285946,-0.135446892
12,I12H,10,14,6,11,24,-0.322914242,-0.016693827,-0.169804035
12,I12M,17,19,13,9,36,-0.192145962,-0.266136788,-0.229141375
12,I12P,13,13,4,10,26,-0.502466034,-0.087906143,-0.295186088
12,I12L,37,27,18,14,64,-0.30423203,-0.334757162,-0.319494596
12,I12T,14,22,8,7,36,-0.384031488,-0.363046801,-0.373539145
12,I12N,12,12,4,3,24,-0.469042278,-0.493815082,-0.48142868
12,I12W,16,13,8,2,29,-0.292951019,-0.697935064,-0.495443042
12,I12V,33,28,6,9,61,-0.717365923,-0.490326754,-0.603846339
13,L13I,21,17,73,63,38,0.508094839,0.517180303,0.512637571
13,L13C,20,21,131,27,41,0.727252367,0.125973677,0.426613022
13,L13T,30,38,77,62,68,0.283173238,0.262556394,0.272864816
13,L13A,30,27,47,63,57,0.14774097,0.344816916,0.246278943
13,L13W,16,26,49,26,42,0.295429275,0.099960244,0.19769476
13,L13V,36,43,70,58,79,0.178096088,0.16982696,0.173961524
13,L13G,51,45,75,56,96,0.123969584,0.071168057,0.097568821
13,L13R,47,64,95,58,111,0.162980937,0.023698925,0.093339931
13,L13S,48,54,76,46,102,0.103581227,-0.038674431,0.032453398
13,L13M,16,22,15,27,38,-0.157016898,0.15815836,0.000570731
13,L13K,14,22,17,16,36,-0.083001493,-0.035687867,-0.05934468
13,L13_,22,15,21,12,37,-0.00743319,-0.163775309,-0.085604249
13,L13F,20,19,16,17,39,-0.141683344,-0.044722551,-0.093202947
13,L13D,9,22,22,7,31,0.086505584,-0.299995056,-0.106744736
13,L13N,14,17,25,6,31,0.139751096,-0.357987003,-0.109117953
13,L13Q,19,16,19,9,35,-0.025344779,-0.254237565,-0.139791172
13,L13Y,18,19,7,23,37,-0.446765883,0.102492581,-0.172136651
13,L13E,18,20,14,12,38,-0.185045622,-0.175056319,-0.18005097
13,L13H,23,19,10,8,42,-0.362148044,-0.37716101,-0.369654527
13,L13P,14,22,11,4,36,-0.259092752,-0.567166784,-0.413129768
14,M14F,18,19,35,208,37,0.20644663,1.042427625,0.624437128
14,M14R,35,46,106,111,81,0.345497651,0.437469106,0.391483379
14,M14K,13,15,32,32,28,0.286043668,0.358180878,0.322112273
14,M14Y,9,16,24,30,25,0.212894387,0.378453282,0.295673834
14,M14W,14,19,38,27,33,0.289513416,0.21774405,0.253628733
14,M14T,14,15,46,9,29,0.424904329,-0.175056319,0.124924005
14,M14I,21,17,30,18,38,0.130224813,-0.01024607,0.059989371
14,M14Q,4,14,11,10,18,0.030355371,0.06470402,0.047529696
14,M14L,35,43,73,27,78,0.201532355,-0.148404124,0.026564115
14,M14H,9,6,8,8,15,-0.019949747,0.052187462,0.016118858
14,M14P,20,17,9,24,37,-0.34985587,0.120221348,-0.114817261
14,M14A,20,13,16,9,33,-0.071102269,-0.229413981,-0.150258125
14,M14G,30,48,31,26,78,-0.162549387,-0.164198391,-0.163373889
14,M14S,39,40,28,29,79,-0.210764263,-0.123903797,-0.16733403
14,M14V,35,41,26,26,76,-0.225199235,-0.153062025,-0.18913063
14,M14_,9,9,13,2,18,0.097302161,-0.499567411,-0.201132625
14,M14N,11,13,7,5,24,-0.264922296,-0.317723823,-0.291323059
14,M14E,13,14,9,5,27,-0.217230305,-0.366941845,-0.292086075
14,M14C,21,18,13,6,39,-0.226004229,-0.454897016,-0.340450623
14,M14D,15,10,5,0,25,-0.406894371,-1.112908412,-0.759901392
15,R15C,11,12,30,22,23,0.341078178,0.28358153,0.312329854
15,R15L,33,54,128,68,87,0.396034764,0.196431354,0.296233059
15,R15A,23,28,27,91,51,-0.038917586,0.549849419,0.255465917
15,R15M,25,22,83,21,47,0.472965775,-0.036753621,0.218106077
15,R15T,16,19,49,19,35,0.37259523,0.046792431,0.20969383
15,R15F,12,20,23,31,32,0.091625028,0.288700974,0.190163001
15,R15K,19,14,12,44,33,-0.187607839,0.423798532,0.118095347
15,R15H,10,9,19,8,19,0.229927726,-0.044722551,0.092602588
15,R15Y,18,22,30,23,40,0.108505563,0.069492321,0.088998942
15,R15V,39,39,42,53,78,-0.03423091,0.136831604,0.051300347
15,R15S,55,46,65,50,101,0.04087149,0.00103494,0.020953215
15,R15W,15,19,34,9,34,0.229927726,-0.242003109,-0.006037691
15,R15I,16,14,12,18,30,-0.147490615,0.089456843,-0.029016886
15,R15G,46,58,49,54,104,-0.092291569,0.021238326,-0.035526621
15,R15_,8,16,8,10,24,-0.213769773,-0.054482388,-0.13412608
15,R15Q,13,11,6,11,24,-0.322914242,-0.016693827,-0.169804035
15,R15E,13,12,7,10,25,-0.281955635,-0.071515727,-0.176735681
15,R15D,14,13,6,13,27,-0.372132265,0.00103494,-0.185548663
15,R15N,18,12,6,12,30,-0.416335928,-0.075353406,-0.245844667
15,R15P,18,21,12,6,39,-0.258188913,-0.454897016,-0.356542964
16,M16V,29,38,79,72,67,0.3005088,0.332878883,0.316693842
16,M16Y,10,10,24,15,20,0.30564844,0.183965624,0.244807032
16,M16I,12,17,23,27,29,0.133017713,0.272101712,0.202559713
16,M16W,24,17,34,31,41,0.15074648,0.183965624,0.167356052
16,M16R,38,55,53,54,93,-0.010806368,0.069299772,0.029246702
16,M16Q,15,14,14,19,29,-0.071102269,0.125973677,0.027435704
16,M16E,7,14,14,9,21,0.063596304,-0.040357745,0.01161928
16,M16K,11,6,8,10,17,-0.071102269,0.088185116,0.008541423
16,M16S,30,30,38,26,60,0.035662498,-0.051901135,-0.008119318
16,M16A,18,26,23,22,44,-0.043073546,0.010580258,-0.016246644
16,M16P,13,14,18,10,27,0.061523296,-0.10370041,-0.021088557
16,M16L,29,37,42,26,66,0.037321379,-0.092646103,-0.027662362
16,M16G,40,61,74,28,101,0.096388818,-0.244137238,-0.07387421
16,M16D,9,16,10,9,25,-0.143652937,-0.112908412,-0.128280674
16,M16_,12,16,12,9,28,-0.118526919,-0.160333062,-0.139429991
16,M16T,16,21,16,11,37,-0.119406949,-0.198537415,-0.158972182
16,M16C,18,14,22,5,32,0.073141622,-0.438297754,-0.182578066
16,M16N,5,10,0,7,15,-0.974192256,0.00103494,-0.486578658
16,M16F,20,24,6,3,44,-0.578186748,-0.749087587,-0.663637167
16,M16H,9,10,0,4,19,-1.071102269,-0.299995056,-0.685548663
17,S17G,32,51,109,86,83,0.347041125,0.317304902,0.332173014
17,S17V,32,50,72,92,82,0.174172494,0.351469792,0.262821143
17,S17M,16,16,40,25,32,0.324197643,0.198524344,0.261360993
17,S17F,13,25,55,21,38,0.387051146,0.05342301,0.220237078
17,S17L,32,50,107,49,82,0.344273389,0.081956848,0.213115118
17,S17T,21,20,29,42,41,0.08379969,0.312284101,0.198041896
17,S17A,30,39,61,53,69,0.177221376,0.189360656,0.183291016
17,S17_,15,20,17,29,35,-0.071102269,0.22288369,0.07589071
17,S17C,24,17,36,18,41,0.17488016,-0.042430754,0.066224703
17,S17I,16,19,24,15,35,0.071565234,-0.050117582,0.010723826
17,S17P,22,23,35,15,45,0.123472395,-0.156572913,-0.016550259
17,S17K,14,12,10,17,26,-0.160043353,0.125973677,-0.017034838
17,S17N,13,8,7,15,21,-0.209404968,0.163762238,-0.022821365
17,S17R,37,37,30,34,74,-0.153771843,-0.028928283,-0.091350063
17,S17Q,18,10,9,13,28,-0.232470272,-0.014205027,-0.123337649
17,S17W,22,22,9,23,44,-0.423284788,0.029063664,-0.197110562
17,S17D,15,27,14,8,42,-0.22744947,-0.37716101,-0.30230524
17,S17Y,12,20,18,3,32,-0.009832613,-0.614389013,-0.312110813
17,S17E,18,24,4,21,42,-0.704570725,0.011019161,-0.346775782
17,S17H,8,17,4,6,25,-0.486075617,-0.267810372,-0.376942995
18,K18R,33,48,191,492,81,0.599415102,1.081098003,0.840256553
18,K18V,32,47,210,172,79,0.651120194,0.637021052,0.644070623
18,K18M,11,18,95,41,29,0.735077704,0.448192971,0.591635338
18,K18T,20,19,175,33,39,0.873380403,0.231483861,0.552432132
18,K18H,8,13,37,45,21,0.467288642,0.622400087,0.544844364
18,K18I,15,22,65,63,37,0.469688065,0.528461313,0.499074689
18,K18L,46,57,189,142,103,0.491647988,0.440367634,0.466007811
18,K18A,33,34,112,80,67,0.450497257,0.378041042,0.414269149
18,K18F,31,25,53,108,56,0.20644663,0.583616578,0.395031604
18,K18C,19,30,107,40,49,0.564381477,0.215878788,0.390130133
18,K18Q,9,13,25,34,22,0.283173238,0.484405144,0.383789191
18,K18S,46,54,192,67,100,0.511163661,0.130252475,0.320708068
18,K18G,37,52,118,80,89,0.351232178,0.256307445,0.303769812
18,K18W,24,25,104,23,49,0.552147021,-0.016693827,0.267726597
18,K18Y,20,26,38,53,46,0.148894475,0.362360838,0.255627656
18,K18N,15,15,27,12,30,0.185724064,-0.075353406,0.055185329
18,K18E,12,11,41,4,23,0.472965775,-0.379176302,0.046894737
18,K18D,16,21,13,12,37,-0.203727835,-0.163775309,-0.183751572
18,K18_,17,22,15,10,39,-0.168012282,-0.25860237,-0.213307326
18,K18P,17,22,14,9,39,-0.196041006,-0.299995056,-0.248018031
19,M19L,36,46,161,93,82,0.520364648,0.356114697,0.438239673
19,M19W,17,16,63,29,33,0.504628783,0.247707273,0.376168028
19,M19K,19,15,35,22,34,0.242162183,0.119724727,0.180943455
19,M19V,49,45,74,72,94,0.127265384,0.187664191,0.157464787
19,M19N,13,21,22,28,34,0.047587518,0.220394889,0.133991204
19,M19T,24,20,27,34,44,0.023873244,0.192920466,0.108396855
19,M19D,16,11,25,13,27,0.197743043,0.00103494,0.099388991
19,M19H,9,11,5,32,20,-0.314140318,0.498359581,0.092109631
19,M19R,54,54,80,59,108,0.100986247,0.042789688,0.071887968
19,M19P,13,23,17,30,36,-0.083001493,0.225224905,0.071111706
19,M19F,14,15,21,15,29,0.095229152,0.029063664,0.062146408
19,M19I,29,23,40,22,52,0.118435713,-0.060483098,0.028976308
19,M19G,49,51,81,33,100,0.139420205,-0.170777521,-0.015678658
19,M19_,17,18,21,15,35,0.016047906,-0.050117582,-0.017034838
19,M19A,17,29,16,24,46,-0.21172121,0.027907086,-0.091907062
19,M19E,20,14,8,20,34,-0.359897809,0.080216186,-0.139840811
19,M19Y,16,22,13,15,38,-0.215008845,-0.084879689,-0.149944267
19,M19C,13,20,20,7,33,0.020668104,-0.326323994,-0.152827945
19,M19S,52,51,55,19,103,-0.038917586,-0.413938408,-0.226427997
19,M19Q,15,22,10,8,37,-0.308463185,-0.323476151,-0.315969668
20,Q20G,28,22,69,53,50,0.36745559,0.326888519,0.347172055
20,Q20Y,18,26,63,29,44,0.382895186,0.125973677,0.254434432
20,Q20C,11,18,30,23,29,0.244168165,0.205154923,0.224661544
20,Q20S,34,26,39,72,60,0.046657882,0.380057961,0.213357922
20,Q20R,38,43,96,42,81,0.302885608,0.021719539,0.162302573
20,Q20H,23,12,39,17,35,0.275685217,0.00103494,0.138360078
20,Q20F,20,22,27,34,42,0.043617302,0.212664524,0.128140913
20,Q20W,19,16,15,40,35,-0.122254792,0.358546292,0.11814575
20,Q20T,19,29,34,30,48,0.08379969,0.10323055,0.09351512
20,Q20I,25,23,19,51,48,-0.159238358,0.327872199,0.084316921
20,Q20L,49,53,65,66,102,0.036634437,0.115302514,0.075968475
20,Q20V,30,39,44,41,69,0.0380422,0.080216186,0.059129193
20,Q20E,14,14,26,11,28,0.198893492,-0.081151816,0.058870838
20,Q20_,24,16,24,22,40,0.015083878,0.051008915,0.033046397
20,Q20M,13,19,15,21,32,-0.084466231,0.125973677,0.020753723
20,Q20A,20,24,27,20,44,0.023873244,-0.028928283,-0.00252752
20,Q20N,18,21,37,10,39,0.207651331,-0.25860237,-0.025475519
20,Q20P,19,21,24,11,40,0.015083878,-0.231537675,-0.108226898
20,Q20D,13,18,14,6,31,-0.099130993,-0.357987003,-0.228558998
20,Q20K,10,25,10,11,35,-0.284982089,-0.175056319,-0.230019204
21,L21P,16,24,18,81,40,-0.10410253,0.603094931,0.249496201
21,L21I,31,17,47,28,48,0.220972884,0.074266854,0.147619869
21,L21T,25,35,47,31,60,0.125839129,0.021885079,0.073862104
21,L21R,64,52,48,90,116,-0.148062056,0.192920466,0.022429205
21,L21_,20,19,36,10,39,0.196069459,-0.25860237,-0.031266456
21,L21N,18,18,11,13,36,-0.259092752,-0.120008753,-0.189550752
21,L21H,21,20,13,12,41,-0.247193529,-0.207241002,-0.227217265
21,L21Q,14,24,13,10,38,-0.215008845,-0.247606986,-0.231307916
21,L21C,20,17,8,11,37,-0.395613361,-0.198537415,-0.297075388
21,L21K,18,26,9,14,44,-0.423284788,-0.175056319,-0.299170553
21,L21S,35,61,28,21,96,-0.29444601,-0.342284118,-0.318365064
21,L21E,22,27,16,6,49,-0.238593357,-0.551807029,-0.395200193
21,L21V,44,54,23,18,98,-0.385496227,-0.414816658,-0.400156442
21,L21Y,18,23,4,15,41,-0.69435156,-0.117064372,-0.405707966
21,L21M,20,18,6,8,38,-0.516038841,-0.334757162,-0.425398001
21,L21W,24,35,9,11,59,-0.548223524,-0.396905069,-0.472564296
21,L21A,16,22,6,5,38,-0.516038841,-0.510848421,-0.513443631
21,L21F,25,28,9,7,53,-0.502466034,-0.527238837,-0.514852435
21,L21G,46,42,11,16,88,-0.640281034,-0.41687615,-0.528578592
21,L21D,21,28,4,3,49,-0.770072274,-0.794845077,-0.782458676
22,G22I,28,18,45,63,46,0.2205877,0.436147052,0.328367376
22,G22L,46,59,94,145,105,0.182345466,0.441111926,0.311728696
22,G22H,10,22,45,28,32,0.374171618,0.245948994,0.310060306
22,G22T,21,35,32,59,56,-0.00743319,0.32434133,0.15845407
22,G22W,25,31,35,46,56,0.030355371,0.218287938,0.124321655
22,G22E,10,18,27,11,28,0.21468776,-0.081151816,0.066767972
22,G22M,21,23,31,24,44,0.081865191,0.046792431,0.064328811
22,G22P,27,21,44,20,48,0.19294416,-0.06591185,0.063516155
22,G22F,29,24,42,24,53,0.131002422,-0.032388815,0.049306803
22,G22R,63,47,72,60,110,0.047927608,0.042071792,0.0449997
22,G22D,27,21,36,19,48,0.10793337,-0.087101149,0.010416111
22,G22K,0,1,0,0,1,-0.071102269,0.00103494,-0.035033665
22,G22Y,13,30,27,11,43,0.033633081,-0.262206495,-0.114286707
22,G22C,24,31,14,27,55,-0.342169042,0.00103494,-0.170567051
22,G22Q,7,13,3,13,20,-0.490231577,0.125973677,-0.18212895
22,G22S,56,62,32,52,118,-0.327105295,-0.049206156,-0.188155726
22,G22N,18,33,8,27,51,-0.531833108,0.033219623,-0.249306742
22,G22V,60,66,49,28,126,-0.17490599,-0.339340787,-0.257123389
22,G22A,46,36,37,15,82,-0.10936677,-0.412893174,-0.261129972
22,G22_,14,10,2,11,24,-0.690891028,-0.016693827,-0.353792427
23,S23I,13,13,73,44,26,0.667795682,0.523913685,0.595854684
23,S23F,18,21,78,90,39,0.525494826,0.659046337,0.592270581
23,S23Y,21,16,79,25,37,0.553234117,0.137254687,0.345244402
23,S23M,18,26,45,31,44,0.239473044,0.1540024,0.196737722
23,S23W,26,26,42,42,52,0.139120312,0.211257522,0.175188917
23,S23L,57,55,108,68,112,0.214275781,0.087835583,0.151055682
23,S23R,45,57,100,50,102,0.221411875,-0.003202113,0.109104881
23,S23C,26,23,29,36,49,0.008078977,0.171296655,0.089687816
23,S23K,21,22,22,36,43,-0.051797114,0.226813983,0.087508434
23,S23H,10,10,12,10,20,0.021651784,0.021238326,0.021445055
23,S23N,15,16,38,7,31,0.315842355,-0.299995056,0.00792365
23,S23V,52,64,62,54,116,-0.038917586,-0.025758237,-0.032337911
23,S23D,22,18,15,19,40,-0.178736148,-0.009688925,-0.094212537
23,S23A,44,38,47,22,82,-0.007909129,-0.255285321,-0.131597225
23,S23P,26,24,23,11,50,-0.097431208,-0.326323994,-0.211877601
23,S23T,31,32,25,16,63,-0.1612789,-0.273666117,-0.217472508
23,S23Q,19,12,8,10,31,-0.320979743,-0.161692357,-0.24133605
23,S23_,14,30,15,11,44,-0.219164805,-0.271966332,-0.245565568
23,S23G,70,62,40,35,132,-0.281140058,-0.265484204,-0.273312131
23,S23E,20,32,16,11,52,-0.263899222,-0.343029688,-0.303464455
24,S24A,36,49,37,104,85,-0.124787128,0.388755784,0.131984328
24,S24V,45,71,99,50,116,0.161741864,-0.05855075,0.051595557
24,S24L,53,60,103,40,113,0.190056214,-0.142056059,0.024000078
24,S24R,56,67,70,66,123,-0.01223561,0.034718053,0.011241221
24,S24I,16,11,16,11,27,0.013218616,-0.06591185,-0.026346617
24,S24H,0,1,0,0,1,-0.071102269,0.00103494,-0.035033665
24,S24F,21,25,24,20,46,-0.044230123,-0.047813627,-0.046021875
24,S24Y,27,29,25,27,56,-0.110973782,-0.006651889,-0.058812835
24,S24K,1,1,1,0,2,0.053836467,-0.175056319,-0.060609926
24,S24C,33,20,14,40,53,-0.326374775,0.182455033,-0.071959871
24,S24W,22,28,15,24,50,-0.273522467,-0.007565232,-0.140543849
24,S24G,66,69,44,51,135,-0.250398668,-0.115470629,-0.182934649
24,S24N,19,32,21,13,51,-0.143652937,-0.267810372,-0.205731654
24,S24T,40,42,24,24,82,-0.291210358,-0.219073148,-0.255141753
24,S24E,23,29,23,8,52,-0.114136902,-0.467968424,-0.291052663
24,S24P,25,36,23,8,61,-0.182252722,-0.536084244,-0.359168483
24,S24Q,15,17,13,3,32,-0.142458178,-0.614389013,-0.378423595
24,S24D,28,34,22,6,62,-0.207684987,-0.652177574,-0.42993128
24,S24M,25,21,11,6,46,-0.362988886,-0.524934882,-0.443961884
24,S24_,24,32,6,7,56,-0.680849089,-0.550719933,-0.615784511
25,S25W,18,22,28,119,40,0.079541867,0.768462325,0.424002096
25,S25F,12,17,84,14,29,0.682225397,0.00103494,0.341630169
25,S25H,11,8,11,32,19,0.008078977,0.51954888,0.263813928
25,S25A,27,31,45,51,58,0.121833546,0.247216268,0.184524907
25,S25Y,17,21,29,31,38,0.115984374,0.216150307,0.16606734
25,S25T,21,31,24,59,52,-0.096408135,0.355940316,0.129766091
25,S25K,23,21,24,41,44,-0.025344779,0.272101712,0.123378467
25,S25L,56,47,73,55,103,0.082126107,0.033219623,0.057672865
25,S25V,34,48,32,46,82,-0.170636426,0.055084701,-0.057775863
25,S25R,49,52,47,46,101,-0.097431208,-0.034437378,-0.065934293
25,S25I,18,9,13,10,27,-0.071102269,-0.10370041,-0.08740134
25,S25M,15,18,7,23,33,-0.398461204,0.15079726,-0.123831972
25,S25P,30,18,14,22,48,-0.284177095,-0.026403308,-0.155290202
25,S25G,39,34,26,28,73,-0.207940229,-0.104768786,-0.156354508
25,S25Q,18,21,11,18,39,-0.292951019,-0.021241455,-0.157096237
25,S25N,12,18,9,8,30,-0.261433968,-0.235054249,-0.248244108
25,S25C,20,16,3,22,36,-0.736214007,0.095591048,-0.320311479
25,S25E,28,18,14,8,46,-0.266078873,-0.415790413,-0.340934643
25,S25D,13,16,6,3,29,-0.402095489,-0.572996328,-0.487545908
25,S25_,24,33,13,6,57,-0.387372232,-0.616265018,-0.501818625
26,E26R,46,47,95,134,93,0.239071106,0.459270851,0.349170978
26,E26F,23,33,78,56,56,0.371679962,0.302064936,0.336872449
26,E26Y,21,25,39,73,46,0.15988986,0.499198798,0.329544329
26,E26P,25,25,38,71,50,0.113422157,0.451827256,0.282624707
26,E26W,26,28,59,39,54,0.267716287,0.163762238,0.215739262
26,E26H,19,16,56,15,35,0.429500081,-0.050117582,0.189691249
26,E26V,57,71,91,103,128,0.083125843,0.208508565,0.145817204
26,E26L,60,73,135,69,133,0.236361836,0.020058177,0.128210007
26,E26A,22,28,44,25,50,0.175570064,0.009468108,0.092519086
26,E26K,20,19,20,30,39,-0.04991297,0.191366638,0.070726834
26,E26M,15,25,28,20,40,0.079541867,0.011500374,0.045521121
26,E26I,20,22,35,17,42,0.152761771,-0.076131015,0.038315378
26,E26C,24,35,40,28,59,0.064560333,-0.013688317,0.025436008
26,E26S,52,47,57,54,99,-0.00664428,0.042427625,0.017891672
26,E26T,25,34,23,42,59,-0.168012282,0.157382141,-0.005315071
26,E26D,24,19,16,28,43,-0.183076029,0.121010257,-0.031032886
26,E26G,42,64,57,36,106,-0.036028058,-0.159117118,-0.097572588
26,E26N,13,17,9,13,30,-0.261433968,-0.043168722,-0.152301345
26,E26Q,8,27,15,7,35,-0.122254792,-0.351147578,-0.236701185
26,E26_,20,30,11,10,50,-0.398461204,-0.364112555,-0.38128688
27,D27I,25,13,128,89,38,0.749452829,0.665242838,0.707347834
27,D27V,35,35,125,193,70,0.479039923,0.738608317,0.60882412
27,D27R,49,57,233,222,106,0.569759806,0.620986021,0.595372913
27,D27M,18,30,151,57,48,0.721575234,0.375296849,0.548436042
27,D27F,10,23,61,65,33,0.490840499,0.590129954,0.540485226
27,D27P,23,24,120,44,47,0.631471859,0.274036212,0.452754036
27,D27K,21,16,76,40,37,0.536634855,0.335065196,0.435850025
27,D27L,50,58,173,118,108,0.433050477,0.340185399,0.386617938
27,D27A,20,39,50,110,59,0.159346652,0.569236664,0.364291658
27,D27C,15,25,54,43,40,0.357506559,0.332733755,0.345120157
27,D27E,21,23,83,27,44,0.500994498,0.096010453,0.298502476
27,D27N,14,20,29,43,34,0.162980937,0.401449568,0.282215252
27,D27H,18,12,32,29,30,0.257079972,0.287824497,0.272452234
27,D27G,51,55,136,82,106,0.337264516,0.19175925,0.264511883
27,D27T,19,32,39,60,51,0.115984374,0.371391427,0.2436879
27,D27Q,17,12,69,10,29,0.597904511,-0.133663634,0.232120439
27,D27Y,21,14,29,35,35,0.15074648,0.302064936,0.226405708
27,D27S,49,55,61,76,104,0.001130117,0.167366362,0.084248239
27,D27_,12,27,14,16,39,-0.196041006,-0.069546134,-0.13279357
27,D27W,29,27,27,15,56,-0.078789098,-0.249689937,-0.164239518
28,L28K,13,18,79,168,31,0.627867735,1.024801662,0.826334698
28,L28P,12,16,77,55,28,0.659624331,0.587854965,0.623739648
28,L28W,31,23,108,66,54,0.526991535,0.387777049,0.457384292
28,L28D,22,21,36,118,43,0.154676774,0.734159221,0.444417997
28,L28H,12,12,26,26,24,0.263351482,0.335488691,0.299420086
28,L28C,12,27,44,37,39,0.281080249,0.279788541,0.280434395
28,L28R,51,52,141,73,103,0.365182731,0.154263316,0.259723024
28,L28G,57,47,108,73,104,0.246164925,0.150107356,0.198136141
28,L28A,37,31,51,51,68,0.107081979,0.179219189,0.143150584
28,L28T,21,29,34,38,50,0.066425594,0.185559367,0.125992481
28,L28V,50,53,55,97,103,-0.038917586,0.276257672,0.118670043
28,L28M,23,14,33,19,37,0.181623047,0.023311335,0.102467191
28,L28F,25,32,31,41,57,-0.028350289,0.161886233,0.066767972
28,L28N,15,21,25,20,36,0.07669935,0.056082506,0.066390928
28,L28S,50,50,49,62,100,-0.075423643,0.097084111,0.010830234
28,L28Q,10,10,12,9,20,0.021651784,-0.020154359,0.000748712
28,L28Y,12,39,28,20,51,-0.02367762,-0.091719113,-0.057698366
28,L28I,29,21,14,29,50,-0.301551191,0.071616014,-0.114967588
28,L28E,15,20,12,16,35,-0.212431422,-0.023788644,-0.118110033
28,L28_,15,17,10,0,32,-0.247193529,-1.216449004,-0.731821266
29,N29F,15,15,26,29,30,0.169929796,0.287824497,0.228877147
29,N29C,12,12,27,17,24,0.279145749,0.159397432,0.21927159
29,N29Y,6,17,25,13,23,0.264689832,0.06798173,0.166335781
29,N29G,34,31,38,41,65,0.001448398,0.105770291,0.053609344
29,N29P,20,21,39,15,41,0.208738427,-0.117064372,0.045837028
29,N29R,42,45,43,57,87,-0.071102269,0.121010257,0.024953994
29,N29T,17,25,21,24,42,-0.061118049,0.066536489,0.00270922
29,N29L,40,44,50,35,84,0.008078977,-0.071051489,-0.031486256
29,N29H,10,10,8,8,20,-0.138049059,-0.06591185,-0.101980454
29,N29A,20,22,9,32,42,-0.403540729,0.18711042,-0.108215155
29,N29D,13,20,12,13,33,-0.187607839,-0.083285946,-0.135446892
29,N29W,20,22,20,11,42,-0.081321435,-0.252222274,-0.166771854
29,N29V,38,41,34,23,79,-0.129094216,-0.22081381,-0.174954013
29,N29M,16,20,28,5,36,0.124124,-0.487985538,-0.181930769
29,N29E,13,13,6,11,26,-0.356337998,-0.050117582,-0.20322779
29,N29S,39,45,37,19,84,-0.119707603,-0.326323994,-0.223015799
29,N29I,13,16,3,15,29,-0.645133537,0.029063664,-0.308034937
29,N29Q,12,15,2,8,27,-0.74010905,-0.190850586,-0.465479818
29,N29K,13,22,5,5,35,-0.548223524,-0.476086315,-0.512154919
29,N29_,16,18,1,2,34,-1.013110323,-0.764881854,-0.888996088
30,G30W,21,34,58,21,55,0.252591711,-0.10370041,0.07444565
30,G30C,30,19,23,29,49,-0.088831036,0.080216186,-0.004307425
30,G30Y,9,17,15,9,26,0.002683945,-0.129298828,-0.063307442
30,G30M,15,21,15,17,36,-0.134154015,-0.010864283,-0.072509149
30,G30Q,14,15,17,9,29,0.008078977,-0.175056319,-0.083488671
30,G30L,64,57,43,60,121,-0.212979428,0.00103494,-0.105972244
30,G30T,23,22,16,20,45,-0.202381184,-0.038473601,-0.120427393
30,G30F,27,29,25,20,56,-0.110973782,-0.131590625,-0.121282203
30,G30R,57,59,52,41,116,-0.113982266,-0.142871636,-0.128426951
30,G30I,10,17,17,6,27,0.0380422,-0.299995056,-0.130976428
30,G30A,40,47,35,31,87,-0.158252445,-0.137267758,-0.147760102
30,G30S,42,56,35,38,98,-0.209404968,-0.102505652,-0.15595531
30,G30N,15,16,19,6,31,0.025807744,-0.357987003,-0.16608963
30,G30P,22,28,12,25,50,-0.363699098,0.009468108,-0.177115495
30,G30D,11,21,10,11,32,-0.247193529,-0.137267758,-0.192230643
30,G30V,56,68,37,48,124,-0.28719869,-0.104648997,-0.195923844
30,G30H,13,11,4,12,24,-0.469042278,0.018068279,-0.225486999
30,G30K,14,10,7,6,24,-0.264922296,-0.250777033,-0.257849664
30,G30_,21,23,11,9,44,-0.344103542,-0.351147578,-0.34762556
30,G30E,24,23,11,6,47,-0.372132265,-0.534078262,-0.453105263
31,I31C,12,23,40,22,35,0.286409082,0.107490271,0.196949677
31,I31W,20,23,25,41,43,0.001448398,0.28186155,0.141654974
31,I31Y,6,19,24,14,25,0.212894387,0.063182847,0.138038617
31,I31F,10,15,16,16,25,0.0454033,0.117540509,0.081471904
31,I31A,22,25,40,23,47,0.161470346,0.00103494,0.081252643
31,I31V,38,39,37,63,77,-0.08238328,0.216150307,0.066883514
31,I31G,54,46,59,49,100,0.003757603,-0.003286434,0.000235585
31,I31H,11,7,4,19,18,-0.34985587,0.32434133,-0.01275727
31,I31R,40,49,52,40,89,-3.89E-05,-0.039393717,-0.019716315
31,I31N,12,11,16,8,23,0.080165406,-0.123903797,-0.021869195
31,I31K,10,13,8,15,23,-0.196041006,0.125973677,-0.035033665
31,I31M,10,8,29,2,18,0.42829538,-0.499567411,-0.035636015
31,I31S,44,48,68,30,92,0.100293868,-0.175056319,-0.037381225
31,I31Q,11,16,7,19,27,-0.314140318,0.1559369,-0.079101709
31,I31T,21,19,21,8,40,-0.04043345,-0.356476412,-0.198454931
31,I31L,33,43,35,17,76,-0.100260498,-0.329153284,-0.214706891
31,I31D,12,15,8,7,27,-0.262987796,-0.242003109,-0.252495452
31,I31P,15,14,4,11,29,-0.548223524,-0.095875073,-0.322049299
31,I31_,14,13,15,2,27,-0.013110323,-0.667971841,-0.340541082
31,I31E,7,14,7,2,21,-0.209404968,-0.56323649,-0.386320729
32,I32H,9,4,30,18,13,0.575161384,0.434690501,0.504925943
32,I32C,22,18,236,20,40,0.991892215,0.011500374,0.501696295
32,I32F,13,23,88,37,36,0.611116009,0.313646808,0.462381409
32,I32T,20,25,59,58,45,0.345321145,0.410159116,0.37774013
32,I32A,22,30,52,78,52,0.229927726,0.475416157,0.352671942
32,I32L,53,49,99,134,102,0.217090501,0.41956148,0.31832599
32,I32S,48,38,60,108,86,0.075738309,0.399972181,0.237855245
32,I32M,20,14,31,32,34,0.19100966,0.276510831,0.233760246
32,I32K,11,14,16,28,25,0.0454033,0.349489586,0.197446443
32,I32N,3,9,12,8,12,0.229927726,0.142364093,0.18614591
32,I32W,23,19,63,19,42,0.402639245,-0.030373524,0.18613286
32,I32R,56,44,104,50,100,0.246795651,0.005313738,0.126054695
32,I32G,42,53,60,78,95,0.032986328,0.217420794,0.125203561
32,I32Y,14,18,16,18,32,-0.058137292,0.062304597,0.002083652
32,I32E,3,2,2,2,5,-0.071102269,0.00103494,-0.035033665
32,I32Q,7,16,18,4,23,0.128470085,-0.379176302,-0.125353108
32,I32V,30,60,46,27,90,-0.057015808,-0.209818425,-0.133417117
32,I32D,21,18,15,13,39,-0.168012282,-0.15386702,-0.160939651
32,I32P,20,17,17,9,37,-0.094583365,-0.277718661,-0.186151013
32,I32_,16,8,4,4,24,-0.469042278,-0.396905069,-0.432973673
33,T33V,44,30,61,177,74,0.147258152,0.677423675,0.412340913
33,T33W,6,15,25,33,21,0.302478393,0.491121172,0.396799783
33,T33L,54,48,131,131,102,0.337664433,0.409801642,0.373733037
33,T33Y,10,21,36,29,31,0.292979472,0.274036212,0.283507842
33,T33I,17,17,14,29,34,-0.138049059,0.235118146,0.048534543
33,T33D,16,17,25,14,33,0.113422157,-0.053322722,0.030049717
33,T33N,13,15,3,55,28,-0.63041028,0.587854965,-0.021277658
33,T33R,26,38,29,27,64,-0.105864376,-0.06369039,-0.084777383
33,T33P,24,30,23,24,54,-0.130223722,-0.040357745,-0.085290733
33,T33Q,13,14,19,6,27,0.08379969,-0.299995056,-0.108097683
33,T33S,46,41,40,32,87,-0.101771089,-0.123903797,-0.112837443
33,T33K,16,19,14,14,35,-0.150283516,-0.078146306,-0.114214911
33,T33M,23,13,19,10,36,-0.037244002,-0.224744103,-0.130994053
33,T33G,29,58,37,30,87,-0.134771349,-0.151056043,-0.142913696
33,T33H,13,15,9,10,28,-0.232470272,-0.118940377,-0.175705324
33,T33C,22,21,11,17,43,-0.334343704,-0.086115236,-0.21022947
33,T33A,22,34,12,24,56,-0.412003777,-0.055869911,-0.233936844
33,T33E,11,25,6,13,36,-0.493175958,-0.120008753,-0.306592355
33,T33F,14,30,6,19,44,-0.578186748,-0.050117582,-0.314152165
33,T33_,14,24,5,3,38,-0.58298563,-0.68693968,-0.634962655
34,Q34T,1,1,5,2,2,0.530957722,0.302064936,0.416511329
34,Q34P,1,2,2,7,3,0.10498899,0.603094931,0.35404196
34,Q34R,2,2,7,3,4,0.434047709,0.205154923,0.319601316
34,Q34V,4,0,5,3,4,0.309108972,0.205154923,0.257131947
34,Q34N,1,3,2,5,4,0.008078977,0.381246182,0.194662579
34,Q34H,3,3,3,2,6,-0.013110323,-0.06591185,-0.039511086
34,Q34E,3,2,2,1,5,-0.071102269,-0.175056319,-0.123079294
34,Q34I,1,6,3,1,7,-0.071102269,-0.299995056,-0.185548663
34,Q34L,4,3,3,1,7,-0.071102269,-0.299995056,-0.185548663
34,Q34S,7,5,1,6,12,-0.58298563,0.033219623,-0.274883004
34,Q34D,3,1,0,1,4,-0.469042278,-0.095875073,-0.282458676
34,Q34_,1,3,1,0,4,-0.168012282,-0.396905069,-0.282458676
34,Q34F,1,3,0,1,4,-0.469042278,-0.095875073,-0.282458676
34,Q34Y,1,6,1,1,7,-0.372132265,-0.299995056,-0.33606366
34,Q34M,0,3,0,0,3,-0.372132265,-0.299995056,-0.33606366
34,Q34C,3,1,0,0,4,-0.469042278,-0.396905069,-0.432973673
34,Q34W,2,2,0,0,4,-0.469042278,-0.396905069,-0.432973673
34,Q34A,2,5,1,0,7,-0.372132265,-0.601025051,-0.486578658
34,Q34G,3,2,0,0,5,-0.548223524,-0.476086315,-0.512154919
34,Q34K,3,3,0,0,6,-0.615170314,-0.543033104,-0.579101709
35,F35K,22,28,46,42,50,0.194455408,0.227963215,0.211209312
35,F35W,25,32,55,43,57,0.21468776,0.182089619,0.198388689
35,F35Y,21,26,32,44,47,0.067200429,0.274036212,0.17061832
35,F35T,38,45,53,65,83,0.0380422,0.197329585,0.117685893
35,F35P,22,21,23,38,43,-0.033313709,0.249676866,0.108181579
35,F35C,32,28,43,39,60,0.088050568,0.118795092,0.10342283
35,F35S,59,44,66,69,103,0.03896919,0.130129636,0.084549413
35,F35I,22,25,24,23,47,-0.053373503,0.00103494,-0.026169281
35,F35V,75,66,88,58,141,0.027029388,-0.079371397,-0.026171004
35,F35R,53,77,58,74,130,-0.116491558,0.059854903,-0.028318327
35,F35A,36,25,27,33,61,-0.115305932,0.041152163,-0.037076884
35,F35M,21,36,28,27,57,-0.071102269,-0.014205027,-0.042653648
35,F35N,21,28,30,14,49,0.022319416,-0.22081381,-0.099247197
35,F35E,29,34,20,32,63,-0.254032953,0.014398902,-0.119817026
35,F35L,59,73,50,56,132,-0.186353739,-0.06591185,-0.126132794
35,F35D,36,26,17,25,62,-0.314140318,-0.082302266,-0.198221292
35,F35H,23,18,14,12,41,-0.217230305,-0.207241002,-0.212235654
35,F35G,61,66,35,43,127,-0.320979743,-0.161692357,-0.24133605
35,F35Q,17,27,9,15,44,-0.423284788,-0.147027595,-0.285156192
35,F35_,36,34,10,9,70,-0.579937937,-0.549193413,-0.564565675
36,E36M,37,34,297,73,71,0.846811494,0.313964159,0.580387826
36,E36L,89,84,280,250,173,0.438084798,0.461189409,0.449637103
36,E36G,58,75,165,185,133,0.322931016,0.444473082,0.383702049
36,E36Q,15,24,45,51,39,0.290625567,0.416008288,0.353316927
36,E36S,72,75,391,80,147,0.652952078,0.040288239,0.346620158
36,E36C,24,37,91,57,61,0.401323864,0.27310124,0.337212552
36,E36W,32,36,68,64,68,0.229927726,0.276129202,0.253028464
36,E36H,16,19,45,22,35,0.336383057,0.107490271,0.221936664
36,E36F,41,34,64,65,75,0.162027491,0.240795279,0.201411385
36,E36D,6,4,6,11,10,0.033633081,0.339853497,0.186743289
36,E36N,23,29,44,42,52,0.15886437,0.211257522,0.185060946
36,E36A,50,44,103,57,94,0.26923746,0.087769324,0.178503392
36,E36R,67,75,123,95,142,0.168013374,0.129000131,0.148506753
36,E36I,43,42,101,37,85,0.304029447,-0.052649919,0.125689764
36,E36K,26,31,38,35,57,0.05756434,0.094939443,0.076251891
36,E36Y,37,39,51,35,76,0.059440345,-0.028123289,0.015658528
36,E36V,71,86,87,80,157,-0.024246689,0.011892868,-0.00617691
36,E36T,33,48,34,48,81,-0.139818082,0.078447163,-0.030685459
36,E36P,33,27,20,26,60,-0.233182814,-0.051901135,-0.142541975
36,E36_,28,39,18,9,67,-0.323827586,-0.530443977,-0.427135781
37,S37I,39,31,97,72,70,0.369895453,0.314129447,0.34201245
37,S37Y,40,48,97,105,88,0.271763795,0.377980794,0.324872295
37,S37V,79,99,193,199,178,0.264876425,0.3502419,0.307559163
37,S37K,13,21,65,16,34,0.505403617,-0.011554187,0.246924715
37,S37L,84,117,178,182,201,0.177429388,0.259164656,0.218297022
37,S37F,56,46,96,83,102,0.203862236,0.213506997,0.208684616
37,S37W,32,51,56,90,83,0.061523296,0.336827042,0.199175169
37,S37R,83,94,174,100,177,0.222545773,0.055966307,0.13925604
37,S37C,53,42,66,72,95,0.073731296,0.183116563,0.128423929
37,S37M,33,37,58,36,70,0.149521389,0.019008311,0.08426485
37,S37T,42,45,33,91,87,-0.183076029,0.321370091,0.069147031
37,S37A,28,29,42,29,57,0.099968188,0.015758197,0.057863193
37,S37H,21,34,20,47,55,-0.196041006,0.235118146,0.01953857
37,S37N,25,28,33,25,53,0.029012883,-0.015355476,0.006828704
37,S37P,33,28,47,13,61,0.118777274,-0.344198718,-0.112710722
37,S37Q,15,21,14,14,36,-0.162182739,-0.090045529,-0.126114134
37,S37G,73,106,53,80,179,-0.292951019,-0.044722551,-0.168836785
37,S37E,26,40,13,21,66,-0.450019041,-0.181587186,-0.315803114
37,S37D,30,53,15,20,83,-0.490231577,-0.299995056,-0.395113316
37,S37_,24,44,6,15,68,-0.763823325,-0.332664172,-0.548243748
38,L38C,27,31,118,50,58,0.534622676,0.2387831,0.386702888
38,L38W,16,31,67,38,47,0.381195402,0.211888305,0.296541853
38,L38F,31,35,43,60,66,0.0473056,0.261319968,0.154312784
38,L38R,42,42,85,44,84,0.235007252,0.025858524,0.130432888
38,L38T,22,19,35,24,41,0.162980937,0.076755654,0.119868295
38,L38Q,10,8,12,13,18,0.065117478,0.16943937,0.117278424
38,L38M,19,21,26,30,40,0.048507634,0.180642773,0.114575203
38,L38H,34,21,27,33,55,-0.071102269,0.085355826,0.007126778
38,L38G,64,63,81,59,127,0.036531609,-0.026993784,0.004768913
38,L38Y,28,23,34,21,51,0.057992427,-0.071515727,-0.00676165
38,L38I,28,25,87,8,53,0.442016639,-0.476086315,-0.017034838
38,L38N,17,30,20,25,47,-0.129094216,0.035797046,-0.046648585
38,L38S,55,81,97,28,136,0.084433235,-0.372257634,-0.143912199
38,L38A,23,23,19,15,46,-0.141140136,-0.16591294,-0.153526538
38,L38K,16,16,8,16,32,-0.334343704,0.013999917,-0.160171894
38,L38D,20,32,19,18,52,-0.193318148,-0.143457333,-0.16838774
38,L38P,23,32,22,15,55,-0.156532465,-0.242003109,-0.199267787
38,L38E,11,16,11,4,27,-0.138049059,-0.446123091,-0.292086075
38,L38V,43,62,32,23,105,-0.276864199,-0.343029688,-0.309946944
38,L38_,9,28,5,0,37,-0.57170462,-1.277718661,-0.92471164
39,K39N,0,0,0,1,0,0.229927726,0.603094931,0.416511329
39,K39L,1,1,3,1,2,0.354866463,0.125973677,0.24042007
39,K39H,1,3,3,3,4,0.133017713,0.205154923,0.169086318
39,K39E,1,2,2,2,3,0.10498899,0.177126199,0.141057594
39,K39Q,0,2,1,1,2,0.053836467,0.125973677,0.089905072
39,K39Y,1,0,0,0,1,-0.071102269,0.00103494,-0.035033665
39,K39D,0,1,0,0,1,-0.071102269,0.00103494,-0.035033665
39,K39F,1,2,0,3,3,-0.372132265,0.302064936,-0.035033665
39,K39P,2,1,0,3,3,-0.372132265,0.302064936,-0.035033665
39,K39S,4,0,2,1,4,0.008078977,-0.095875073,-0.043898048
39,K39R,0,7,4,2,7,0.025807744,-0.123903797,-0.049048027
39,K39C,0,2,0,1,2,-0.247193529,0.125973677,-0.060609926
39,K39V,5,1,1,2,6,-0.314140318,-0.06591185,-0.190026084
39,K39M,0,2,0,0,2,-0.247193529,-0.175056319,-0.211124924
39,K39I,1,1,0,0,2,-0.247193529,-0.175056319,-0.211124924
39,K39G,4,1,0,1,5,-0.548223524,-0.175056319,-0.361639922
39,K39A,3,7,3,0,10,-0.209404968,-0.739327749,-0.474366359
39,K39T,6,3,1,0,9,-0.469042278,-0.697935064,-0.583488671
40,L40F,0,1,28,5,1,1.391295728,0.77918619,1.085240959
40,L40P,0,2,2,8,2,0.229927726,0.77918619,0.504556958
40,L40V,4,6,10,9,10,0.229927726,0.260672251,0.245299988
40,L40S,4,8,9,13,12,0.115984374,0.334249619,0.225116996
40,L40D,0,1,0,1,1,-0.071102269,0.302064936,0.115481333
40,L40K,1,3,3,2,4,0.133017713,0.080216186,0.10661695
40,L40C,1,1,0,2,2,-0.247193529,0.302064936,0.027435704
40,L40W,2,1,0,2,3,-0.372132265,0.177126199,-0.097503033
40,L40G,3,5,2,4,8,-0.247193529,0.046792431,-0.100200549
40,L40I,1,3,3,0,4,0.133017713,-0.396905069,-0.131943678
40,L40M,3,1,0,3,4,-0.469042278,0.205154923,-0.131943678
40,L40Y,1,1,0,0,2,-0.247193529,-0.175056319,-0.211124924
40,L40R,4,8,2,5,12,-0.406894371,-0.033727166,-0.220310769
40,L40_,1,3,0,1,4,-0.469042278,-0.095875073,-0.282458676
40,L40T,3,4,1,1,7,-0.372132265,-0.299995056,-0.33606366
40,L40E,2,5,1,0,7,-0.372132265,-0.601025051,-0.486578658
40,L40A,2,7,2,0,9,-0.292951019,-0.697935064,-0.495443042
40,L40H,1,4,0,0,5,-0.548223524,-0.476086315,-0.512154919
40,L40N,3,3,0,0,6,-0.615170314,-0.543033104,-0.579101709
40,L40Q,5,3,0,0,8,-0.724314783,-0.652177574,-0.688246178
41,Y41K,16,17,196,197,33,0.992915035,1.067251209,1.030083122
41,Y41R,24,43,276,131,67,0.839898583,0.590129954,0.715014268
41,Y41M,19,27,136,50,46,0.694550435,0.337537254,0.516043845
41,Y41N,19,17,56,60,36,0.417600858,0.519193047,0.468396952
41,Y41S,37,42,163,91,79,0.541681587,0.362762776,0.452222182
41,Y41Q,19,16,93,30,35,0.646753079,0.237124129,0.441938604
41,Y41A,6,4,8,29,10,0.14277755,0.737793505,0.440285528
41,Y41C,13,15,38,45,28,0.358594335,0.502424769,0.430509552
41,Y41H,14,23,86,30,37,0.589663382,0.213643033,0.401653208
41,Y41L,59,71,191,162,130,0.395957659,0.396981244,0.396469452
41,Y41I,12,16,82,17,28,0.686607821,0.094939443,0.390773632
41,Y41P,24,29,61,68,53,0.289925656,0.408520267,0.349222961
41,Y41V,8,4,4,38,12,-0.185045622,0.77918619,0.297070284
41,Y41D,5,1,5,7,6,0.162980937,0.360056883,0.26151891
41,Y41T,29,39,65,57,68,0.210622571,0.226643839,0.218633205
41,Y41G,7,8,11,6,15,0.10498899,-0.056957007,0.024015991
41,Y41E,6,3,9,0,9,0.229927726,-0.697935064,-0.234003669
41,Y41W,12,23,9,6,35,-0.326374775,-0.409139525,-0.36775715
41,Y41F,6,8,0,2,14,-0.946163533,-0.396905069,-0.671534301
41,Y41_,18,27,0,3,45,-1.432830106,-0.758632905,-1.095731505
42,R42K,27,21,86,516,48,0.479250899,1.325359399,0.902305149
42,R42Q,21,14,49,35,35,0.37259523,0.302064936,0.337330083
42,R42G,71,73,78,320,144,-0.033813185,0.647201966,0.306694391
42,R42V,58,65,119,83,123,0.215687287,0.132922537,0.174304912
42,R42S,70,83,139,90,153,0.188535041,0.073585607,0.131060324
42,R42W,33,36,42,51,69,0.018298142,0.172970239,0.095634191
42,R42C,22,31,43,26,53,0.140986643,0.00103494,0.071010791
42,R42A,37,42,54,46,79,0.067200429,0.071072807,0.069136618
42,R42I,35,29,59,25,64,0.19516562,-0.095875073,0.049645273
42,R42F,47,34,48,39,81,0.006309954,-0.009688925,-0.001689486
42,R42T,45,54,46,59,99,-0.097974416,0.080216186,-0.008879115
42,R42L,91,94,101,73,185,-0.030985046,-0.098216289,-0.064600668
42,R42N,23,40,19,26,63,-0.275222252,-0.072751274,-0.173986763
42,R42P,38,48,40,22,86,-0.09680767,-0.275726481,-0.186267075
42,R42E,25,23,24,8,48,-0.062328345,-0.433888635,-0.24810849
42,R42H,17,19,12,6,36,-0.224330646,-0.421038748,-0.322684697
42,R42Y,35,29,9,9,64,-0.58298563,-0.510848421,-0.546917026
42,R42D,18,25,4,5,43,-0.714554946,-0.56323649,-0.638895718
42,R42M,28,40,6,9,68,-0.763823325,-0.536784155,-0.65030374
42,R42_,32,41,2,1,73,-1.162182739,-1.266136788,-1.214159764
43,D43C,20,20,173,517,40,0.857693118,1.403610839,1.130651978
43,D43V,27,35,399,406,62,1.032647168,1.112318795,1.072482982
43,D43A,33,43,465,340,76,1.011822918,0.94832859,0.980075754
43,D43F,22,23,525,100,45,1.288155639,0.643628478,0.965892058
43,D43S,46,79,495,762,125,0.825038858,1.084218929,0.954628893
43,D43T,22,38,703,123,60,1.29217055,0.610156786,0.951163668
43,D43G,60,53,509,402,113,0.880593051,0.850465131,0.865529091
43,D43P,26,32,344,158,58,0.99689481,0.732610048,0.864752429
43,D43K,21,13,223,56,34,1.0361077,0.513871747,0.774989724
43,D43R,51,55,425,277,106,0.829953548,0.716725954,0.773339751
43,D43M,18,25,162,115,43,0.798662654,0.723070248,0.760866451
43,D43Y,12,20,85,103,32,0.645912238,0.800584335,0.723248286
43,D43I,23,20,106,142,43,0.615858827,0.813948297,0.714903562
43,D43L,57,68,331,189,125,0.650695265,0.480447992,0.565571628
43,D43W,25,21,51,160,46,0.273833212,0.836792954,0.555313083
43,D43H,22,10,50,58,32,0.418983962,0.554403007,0.486693485
43,D43Q,23,23,86,58,46,0.497349121,0.400819089,0.449084105
43,D43N,18,21,68,29,39,0.466716826,0.177126199,0.321921512
43,D43E,22,18,61,18,40,0.409535559,-0.03196532,0.188785119
43,D43_,15,17,5,2,32,-0.510434963,-0.739327749,-0.624881356
44,S44K,20,26,193,24,46,0.845631598,0.027907086,0.436769342
44,S44I,16,25,72,46,41,0.470001296,0.350913503,0.4104574
44,S44V,50,45,124,111,95,0.344566506,0.369011725,0.356789116
44,S44L,64,83,214,131,147,0.392104471,0.252377152,0.322240811
44,S44P,29,36,73,70,65,0.27961551,0.333779349,0.30669743
44,S44C,24,33,66,57,57,0.292574535,0.302064936,0.297319736
44,S44A,41,39,72,90,80,0.184765567,0.352621309,0.268693438
44,S44M,21,32,46,61,53,0.169631824,0.362062865,0.265847345
44,S44W,18,18,44,27,36,0.314938516,0.181021243,0.247979879
44,S44R,49,62,122,67,111,0.270614815,0.085355826,0.17798532
44,S44Q,23,20,24,48,43,-0.015584942,0.348808339,0.166611699
44,S44G,51,63,99,71,114,0.169229886,0.098699592,0.133964739
44,S44T,41,44,65,54,85,0.11497321,0.107929174,0.111451192
44,S44F,28,26,36,27,54,0.057766761,0.008860278,0.033313519
44,S44Y,28,24,35,23,52,0.061954357,-0.041999692,0.009977333
44,S44N,23,24,30,15,47,0.040048183,-0.175056319,-0.067504068
44,S44H,30,21,46,10,51,0.18602224,-0.372545723,-0.093261741
44,S44D,33,25,28,16,58,-0.078526288,-0.238338155,-0.158432221
44,S44E,23,24,31,8,47,0.053836467,-0.424933792,-0.185548663
44,S44_,29,34,9,5,63,-0.576252248,-0.725963788,-0.651108018
45,L45N,1,8,15,24,9,0.434047709,0.700004944,0.567026327
45,L45R,18,28,115,62,46,0.622287857,0.429307627,0.525797742
45,L45A,13,23,42,77,36,0.295194458,0.625957814,0.460576136
45,L45K,6,4,42,4,10,0.822003497,-0.040357745,0.390822876
45,L45G,22,22,48,69,44,0.266911292,0.493950462,0.380430877
45,L45V,13,30,36,78,43,0.154676774,0.556239351,0.355458062
45,L45C,16,13,42,30,29,0.386274927,0.316305375,0.351290151
45,L45W,18,21,44,44,39,0.281080249,0.353217458,0.317148853
45,L45S,31,34,89,55,65,0.3646263,0.230709027,0.297667664
45,L45H,7,14,31,16,21,0.392655024,0.190091176,0.2913731
45,L45P,13,23,36,39,36,0.229927726,0.335923203,0.282925465
45,L45T,15,9,19,17,24,0.133017713,0.159397432,0.146207573
45,L45F,16,24,34,23,40,0.161211914,0.069492321,0.115352117
45,L45I,7,9,10,11,16,0.04087149,0.15079726,0.095834375
45,L45Y,16,17,43,10,33,0.341901486,-0.188021296,0.076940095
45,L45D,17,17,11,10,34,-0.234959072,-0.200610423,-0.217784748
45,L45Q,14,11,9,5,25,-0.185045622,-0.334757162,-0.259901392
45,L45M,8,12,7,3,20,-0.189201582,-0.418094368,-0.303647975
45,L45E,10,17,8,3,27,-0.262987796,-0.543033104,-0.40301045
45,L45_,13,15,5,0,28,-0.454319021,-1.160333062,-0.807326042
46,G46P,25,17,192,30,42,0.88201658,0.159958174,0.520987377
46,G46K,16,15,38,32,31,0.315842355,0.315428897,0.315635626
46,G46M,19,13,25,42,32,0.126387134,0.417019451,0.271703293
46,G46R,48,49,76,61,97,0.125192376,0.10323055,0.114211463
46,G46Y,15,18,20,24,33,0.020668104,0.168526027,0.094597066
46,G46Q,16,12,15,19,28,-0.028350289,0.140696933,0.056173322
46,G46F,23,38,29,45,61,-0.085342709,0.172431078,0.043544185
46,G46L,53,79,70,85,132,-0.042665566,0.112711746,0.03502309
46,G46D,12,14,16,10,26,0.029012883,-0.087906143,-0.02944663
46,G46W,24,22,33,14,46,0.089308785,-0.193941663,-0.052316439
46,G46N,13,12,8,15,25,-0.230803112,0.09121157,-0.069795771
46,G46E,17,13,9,17,30,-0.261433968,0.065975747,-0.09772911
46,G46C,24,25,23,16,49,-0.088831036,-0.166456147,-0.127643592
46,G46T,34,25,41,10,59,0.075025766,-0.43469363,-0.179833932
46,G46S,57,45,53,24,102,-0.050515739,-0.31283228,-0.18167401
46,G46I,16,31,29,6,47,0.025807744,-0.534078262,-0.254135259
46,G46A,31,33,13,22,64,-0.436857595,-0.149120585,-0.29298909
46,G46V,38,45,19,25,83,-0.393321564,-0.207241002,-0.300281283
46,G46H,15,15,6,8,30,-0.416335928,-0.235054249,-0.325695088
46,G46_,18,23,4,8,41,-0.69435156,-0.366941845,-0.530646703
47,E47I,9,14,188,34,23,1.126178289,0.465921738,0.796050013
47,E47P,12,9,115,34,21,0.951963035,0.503710299,0.727836667
47,E47W,22,25,33,65,47,0.080165406,0.440367634,0.26026652
47,E47K,10,18,30,22,28,0.258891422,0.201394774,0.230143098
47,E47G,31,40,68,39,71,0.21144432,0.046792431,0.129118376
47,E47V,16,19,24,22,35,0.071565234,0.107490271,0.089527753
47,E47Y,23,11,33,13,34,0.217338599,-0.095875073,0.060731763
47,E47D,16,12,15,18,28,-0.028350289,0.118420539,0.045035125
47,E47F,19,38,30,38,57,-0.042138574,0.129701549,0.043781488
47,E47L,40,39,47,44,79,0.008078977,0.052187462,0.03013322
47,E47T,24,20,22,28,44,-0.061556952,0.11125042,0.024846734
47,E47S,34,48,49,44,82,0.009819638,0.036199357,0.023009498
47,E47_,13,12,11,16,25,-0.105864376,0.117540509,0.005838067
47,E47C,19,21,20,23,40,-0.060636836,0.069492321,0.004427742
47,E47N,17,17,24,11,34,0.08379969,-0.162821863,-0.039511086
47,E47Q,10,12,12,8,22,-0.017856758,-0.105420391,-0.061638574
47,E47A,21,22,36,9,43,0.154676774,-0.341387741,-0.093355484
47,E47H,11,6,7,5,17,-0.122254792,-0.175056319,-0.148655555
47,E47M,13,24,11,14,37,-0.270674624,-0.101627402,-0.186151013
47,E47R,54,45,35,23,99,-0.213769773,-0.317723823,-0.265746798
48,A48R,44,44,126,124,88,0.38434144,0.449584942,0.416963191
48,A48W,15,15,43,28,30,0.382018709,0.27310124,0.327559974
48,A48P,13,17,28,20,30,0.20096403,0.132922537,0.166943283
48,A48S,21,36,36,30,57,0.034701457,0.029998636,0.032350046
48,A48C,7,19,11,18,26,-0.122254792,0.149454773,0.01359999
48,A48F,7,19,13,15,26,-0.055308002,0.074821154,0.009756576
48,A48H,7,13,12,9,20,0.021651784,-0.020154359,0.000748712
48,A48K,12,9,8,12,21,-0.158252445,0.073585607,-0.042333419
48,A48N,6,8,6,6,14,-0.101065493,-0.028928283,-0.064996888
48,A48G,39,33,41,25,72,-0.010145844,-0.146284576,-0.07821521
48,A48Q,9,7,18,2,16,0.278232406,-0.451262731,-0.086515163
48,A48D,9,9,8,6,18,-0.094583365,-0.131590625,-0.113086995
48,A48M,11,7,9,5,18,-0.048825875,-0.198537415,-0.123681645
48,A48Y,9,7,19,1,16,0.3005088,-0.62735399,-0.163422595
48,A48V,20,23,11,17,43,-0.334343704,-0.086115236,-0.21022947
48,A48L,29,41,19,27,70,-0.320300627,-0.102035382,-0.211168004
48,A48T,21,23,15,13,44,-0.219164805,-0.205019542,-0.212092174
48,A48I,8,6,7,2,14,-0.043073546,-0.396905069,-0.219989307
48,A48E,12,9,1,5,21,-0.811464959,-0.262206495,-0.536835727
48,A48_,11,13,0,7,24,-1.168012282,-0.192785086,-0.680398684
49,V49Y,12,24,1418,80,36,1.813708398,0.642348231,1.228028314
49,V49L,49,45,193,87,94,0.540005851,0.268824003,0.404414927
49,V49W,13,21,36,49,34,0.254061406,0.456966896,0.355514151
49,V49T,20,18,38,20,38,0.229927726,0.033219623,0.131573675
49,V49Q,10,9,10,14,19,-0.029709584,0.177126199,0.073708307
49,V49H,9,14,20,10,23,0.171935779,-0.036753621,0.067591079
49,V49C,14,18,17,17,32,-0.033313709,0.038823501,0.002754896
49,V49S,49,42,32,69,91,-0.215346161,0.183375148,-0.015985506
49,V49N,10,17,25,7,27,0.197743043,-0.242003109,-0.022130033
49,V49G,35,31,35,27,66,-0.039844576,-0.076851836,-0.058348206
49,V49R,43,45,75,22,88,0.161351312,-0.285597235,-0.062122962
49,V49_,9,15,8,9,24,-0.213769773,-0.095875073,-0.154822423
49,V49A,22,25,12,20,47,-0.337370159,-0.056957007,-0.197163583
49,V49P,11,24,17,7,35,-0.071102269,-0.351147578,-0.211124924
49,V49F,21,25,13,16,46,-0.296042096,-0.139584001,-0.217813048
49,V49K,16,19,10,7,35,-0.284982089,-0.351147578,-0.318064834
49,V49M,16,19,7,8,35,-0.423284788,-0.299995056,-0.361639922
49,V49I,16,11,12,1,27,-0.103286953,-0.8440631,-0.473675026
49,V49D,9,21,2,6,30,-0.784312713,-0.344198718,-0.564255716
49,V49E,20,22,6,3,42,-0.558442689,-0.729343529,-0.643893109
50,M50P,9,23,13,27,32,-0.142458178,0.230709027,0.044125425
50,M50H,5,19,18,8,24,0.110741318,-0.141632564,-0.015445623
50,M50G,34,34,30,35,68,-0.117559671,0.019518346,-0.049020662
50,M50A,18,28,22,14,46,-0.080442296,-0.193941663,-0.137191979
50,M50N,14,14,26,3,28,0.198893492,-0.558273071,-0.179689789
50,M50S,31,55,28,26,86,-0.247193529,-0.206090553,-0.226642041
50,M50I,18,23,13,11,41,-0.247193529,-0.242003109,-0.244598319
50,M50W,16,17,11,8,33,-0.222369945,-0.275171472,-0.248770708
50,M50_,10,19,12,5,29,-0.133250176,-0.396905069,-0.265077622
50,M50R,47,48,36,18,95,-0.184141783,-0.401452696,-0.29279724
50,M50C,23,16,9,8,39,-0.372132265,-0.345752546,-0.358942406
50,M50T,25,29,12,10,54,-0.396491611,-0.396905069,-0.39669834
50,M50L,49,45,14,26,94,-0.57170462,-0.244294905,-0.407999763
50,M50Y,14,20,6,5,34,-0.469042278,-0.463851858,-0.466447068
50,M50Q,10,20,4,4,30,-0.562463963,-0.490326754,-0.526395359
50,M50V,34,39,18,6,73,-0.360550393,-0.722068744,-0.541309568
50,M50F,20,32,9,4,52,-0.494348143,-0.72324093,-0.608794536
50,M50K,11,18,5,1,29,-0.469042278,-0.874026323,-0.671534301
50,M50D,19,21,2,5,40,-0.905734876,-0.532567671,-0.719151273
50,M50E,13,15,0,1,28,-1.232470272,-0.859303067,-1.045886669
51,R51W,13,10,17,6,23,0.10498899,-0.233048266,-0.064029638
51,R51Q,12,7,13,3,19,0.075025766,-0.396905069,-0.160939651
51,R51K,14,11,6,11,25,-0.339947582,-0.033727166,-0.186837374
51,R51S,33,32,29,15,65,-0.112494955,-0.313359017,-0.212926986
51,R51L,41,36,26,23,77,-0.230803112,-0.209818425,-0.220310769
51,R51_,16,23,7,20,39,-0.469042278,0.022224239,-0.22340902
51,R51G,37,39,21,25,76,-0.314140318,-0.169452441,-0.24179638
51,R51P,13,31,11,15,44,-0.344103542,-0.147027595,-0.245565568
51,R51N,14,11,6,8,25,-0.339947582,-0.158665903,-0.249306742
51,R51C,14,11,8,6,25,-0.230803112,-0.267810372,-0.249306742
51,R51A,19,17,10,7,36,-0.296881313,-0.363046801,-0.329964057
51,R51F,10,21,7,7,31,-0.372132265,-0.299995056,-0.33606366
51,R51I,18,18,4,16,36,-0.639303994,-0.035687867,-0.33749593
51,R51V,36,44,14,18,80,-0.502466034,-0.327666482,-0.415066258
51,R51H,18,14,7,4,32,-0.385496227,-0.517479,-0.451487613
51,R51E,14,18,4,6,32,-0.589616209,-0.371350964,-0.480483587
51,R51M,15,10,5,2,25,-0.406894371,-0.635787158,-0.521340764
51,R51D,12,18,2,6,30,-0.784312713,-0.344198718,-0.564255716
51,R51T,19,21,8,3,40,-0.428613621,-0.70865893,-0.568636275
51,R51Y,12,12,4,1,24,-0.469042278,-0.794845077,-0.631943678
52,M52I,14,16,26,33,30,0.169929796,0.342182159,0.256055978
52,M52V,21,35,35,71,56,0.030355371,0.403522576,0.216938974
52,M52_,14,22,9,39,36,-0.338273998,0.335923203,-0.001175397
52,M52L,42,53,72,34,95,0.110979353,-0.136138253,-0.01257945
52,M52D,11,14,20,5,25,0.137173673,-0.334757162,-0.098791744
52,M52Q,11,25,11,20,36,-0.259092752,0.056082506,-0.101505123
52,M52H,13,10,6,6,23,-0.305185476,-0.233048266,-0.269116871
52,M52Y,16,19,10,7,35,-0.284982089,-0.351147578,-0.318064834
52,M52T,21,40,12,18,61,-0.448520611,-0.211573153,-0.330046882
52,M52S,53,56,22,29,109,-0.449737123,-0.262206495,-0.355971809
52,M52N,10,17,4,7,27,-0.518260301,-0.242003109,-0.380131705
52,M52K,13,29,14,5,42,-0.22744947,-0.553252269,-0.39035087
52,M52G,49,54,13,22,103,-0.640977577,-0.353240568,-0.497109073
52,M52A,41,37,13,12,78,-0.521571329,-0.481618803,-0.501595066
52,M52C,14,16,3,5,30,-0.659373976,-0.411145508,-0.535259742
52,M52R,43,54,13,16,97,-0.615170314,-0.458712219,-0.536941266
52,M52F,25,28,8,7,53,-0.548223524,-0.527238837,-0.537731181
52,M52W,18,21,13,1,39,-0.226004229,-0.99896506,-0.612484645
52,M52E,17,15,8,1,32,-0.334343704,-0.915419009,-0.624881356
52,M52P,18,20,2,5,38,-0.884015626,-0.510848421,-0.697432024
53,G53W,18,19,37,18,37,0.229927726,0.00103494,0.115481333
53,G53M,18,16,31,16,34,0.19100966,-0.011554187,0.089727736
53,G53Q,11,8,17,6,19,0.184170236,-0.15386702,0.015151608
53,G53L,63,45,51,62,108,-0.091495428,0.063978987,-0.01375822
53,G53I,16,20,22,14,36,0.023453838,-0.090045529,-0.033295846
53,G53D,11,12,7,14,23,-0.247193529,0.097944953,-0.074624288
53,G53A,24,22,21,18,46,-0.099747451,-0.091279321,-0.095513386
53,G53N,6,12,6,7,18,-0.203727835,-0.073598678,-0.138663257
53,G53E,22,12,8,16,34,-0.359897809,-0.011554187,-0.185725998
53,G53Y,19,15,20,5,34,0.008078977,-0.463851858,-0.227886441
53,G53H,10,14,6,8,24,-0.322914242,-0.141632564,-0.232273403
53,G53V,30,54,31,18,84,-0.194341221,-0.348600389,-0.271470805
53,G53C,19,24,14,9,43,-0.237433691,-0.341387741,-0.289410716
53,G53T,30,24,14,11,54,-0.334343704,-0.359116508,-0.346730106
53,G53R,41,47,21,19,88,-0.3770396,-0.346295075,-0.361667337
53,G53S,43,47,28,12,90,-0.266715668,-0.543033104,-0.404874386
53,G53F,10,27,12,3,37,-0.235912518,-0.67565867,-0.455785594
53,G53K,15,18,4,6,33,-0.602581187,-0.384315941,-0.493448564
53,G53_,23,16,7,4,39,-0.469042278,-0.601025051,-0.535033665
53,G53P,26,27,7,8,53,-0.599376047,-0.476086315,-0.537731181
54,D54H,8,17,150,9,25,0.993931325,-0.112908412,0.440511457
54,D54E,11,14,29,19,25,0.292075633,0.188121583,0.240098608
54,D54M,22,15,14,73,37,-0.173764611,0.591513059,0.208874224
54,D54L,52,58,79,94,110,0.087694734,0.234465562,0.161080148
54,D54F,16,13,22,17,29,0.114534307,0.080216186,0.097375247
54,D54S,32,50,78,38,82,0.208476725,-0.02594855,0.091264088
54,D54A,31,31,48,35,62,0.120783257,0.059026887,0.089905072
54,D54Q,9,11,10,16,20,-0.050898883,0.210294562,0.079697839
54,D54I,11,12,20,8,23,0.171935779,-0.123903797,0.024015991
54,D54V,42,47,47,53,89,-0.043073546,0.080216186,0.01857132
54,D54C,21,21,31,15,42,0.101609249,-0.127283537,-0.012837144
54,D54R,35,47,33,52,82,-0.157671449,0.107262713,-0.025204368
54,D54K,17,10,11,16,27,-0.138049059,0.085355826,-0.026346617
54,D54W,26,29,23,20,55,-0.138049059,-0.123903797,-0.130976428
54,D54G,54,55,36,51,109,-0.243263235,-0.023324406,-0.13329382
54,D54Y,21,33,22,18,54,-0.148707127,-0.159544153,-0.15412564
54,D54N,20,20,7,26,40,-0.479766144,0.120644843,-0.17956065
54,D54P,18,29,22,10,47,-0.089585675,-0.337783617,-0.213684646
54,D54T,27,29,32,9,56,-0.00743319,-0.45380992,-0.230621555
54,D54_,13,19,5,13,32,-0.510434963,-0.070320968,-0.290377966
55,L55M,15,24,11,32,39,-0.292951019,0.218518884,-0.037216067
55,L55G,42,38,35,36,80,-0.122254792,-0.038218359,-0.080236576
55,L55S,32,50,35,30,82,-0.132847865,-0.125651463,-0.129249664
55,L55F,17,23,11,21,40,-0.303674884,0.03170376,-0.135985562
55,L55Q,14,16,10,10,30,-0.220041283,-0.147904073,-0.183972678
55,L55P,11,23,9,12,34,-0.314140318,-0.128059756,-0.221100037
55,L55I,21,14,11,8,35,-0.247193529,-0.299995056,-0.273594292
55,L55R,62,51,24,39,113,-0.429037116,-0.152779924,-0.29090852
55,L55T,18,29,12,12,47,-0.337370159,-0.265232949,-0.301301554
55,L55A,18,21,6,15,39,-0.527034225,-0.095875073,-0.311454649
55,L55C,19,29,10,14,48,-0.418875669,-0.212039885,-0.315457777
55,L55N,14,14,1,24,28,-0.931440276,0.237606946,-0.346916665
55,L55H,13,10,7,3,23,-0.247193529,-0.476086315,-0.361639922
55,L55K,13,18,13,3,31,-0.129094216,-0.601025051,-0.365059634
55,L55W,28,23,5,21,51,-0.707924367,-0.071515727,-0.389720047
55,L55D,11,18,4,7,29,-0.548223524,-0.271966332,-0.410094928
55,L55Y,18,20,9,4,38,-0.361136881,-0.590029667,-0.475583274
55,L55E,15,21,5,6,36,-0.560122748,-0.421038748,-0.490580748
55,L55V,30,32,14,7,62,-0.393321564,-0.594185627,-0.493753595
55,L55_,23,24,3,14,47,-0.84925352,-0.203085043,-0.526169281
56,H56Y,13,24,31,8,37,0.155294108,-0.323476151,-0.084091022
56,H56I,7,25,11,17,32,-0.209404968,0.038823501,-0.085290733
56,H56M,20,20,23,12,40,-0.002644889,-0.196775569,-0.099710229
56,H56F,19,18,15,14,37,-0.145735888,-0.101627402,-0.123681645
56,H56P,20,12,9,15,32,-0.288586214,-0.012329022,-0.150457618
56,H56_,17,16,11,11,33,-0.222369945,-0.150232735,-0.18630134
56,H56L,50,41,28,30,91,-0.271462103,-0.170361198,-0.220911651
56,H56R,43,57,34,19,100,-0.230325603,-0.401226442,-0.315776023
56,H56A,39,50,7,66,89,-0.821224796,0.173897229,-0.323663784
56,H56C,16,15,8,6,31,-0.320979743,-0.357987003,-0.339483373
56,H56D,10,13,4,5,23,-0.451313511,-0.299995056,-0.375654283
56,H56K,18,20,8,7,38,-0.406894371,-0.385909684,-0.396402028
56,H56V,57,50,21,24,107,-0.461073348,-0.333418811,-0.39724608
56,H56G,53,58,26,20,111,-0.387926532,-0.424933792,-0.406430162
56,H56Q,17,13,7,4,30,-0.358343981,-0.490326754,-0.424335367
56,H56S,54,62,22,14,116,-0.4765303,-0.590029667,-0.533279983
56,H56N,12,17,1,6,29,-0.946163533,-0.329958279,-0.638060906
56,H56E,14,15,3,1,29,-0.645133537,-0.874026323,-0.75957993
56,H56T,27,20,2,4,47,-0.974192256,-0.680206297,-0.827199277
56,H56W,31,24,6,1,55,-0.673162261,-1.145093096,-0.909127678
57,S57H,11,8,25,22,19,0.343871078,0.362762776,0.353316927
57,S57G,17,36,47,52,53,0.178775204,0.293947045,0.236361125
57,S57N,10,14,15,27,24,0.0361077,0.351282958,0.193695329
57,S57R,40,41,79,52,81,0.219203861,0.112526953,0.165865407
57,S57M,9,13,16,11,22,0.098648812,0.019518346,0.059083579
57,S57T,25,23,31,23,48,0.044881624,-0.007919903,0.018480861
57,S57K,17,19,12,32,36,-0.224330646,0.252377152,0.014023253
57,S57L,32,54,40,48,86,-0.09680767,0.052741763,-0.022032953
57,S57W,20,21,22,19,41,-0.031593728,-0.020154359,-0.025874044
57,S57A,20,27,22,19,47,-0.089585675,-0.078146306,-0.083865991
57,S57D,10,12,12,6,22,-0.017856758,-0.21456486,-0.116210809
57,S57E,23,21,25,10,44,-0.00831144,-0.309754893,-0.159033166
57,S57_,16,23,14,11,39,-0.196041006,-0.22081381,-0.208427408
57,S57I,16,9,11,5,25,-0.105864376,-0.334757162,-0.220310769
57,S57F,17,26,21,7,43,-0.071102269,-0.438297754,-0.254700012
57,S57Q,11,16,16,3,27,0.013218616,-0.543033104,-0.264907244
57,S57V,36,43,18,24,79,-0.39440866,-0.203085043,-0.298746851
57,S57P,18,21,8,8,39,-0.417889756,-0.345752546,-0.381821151
57,S57Y,16,15,21,1,31,0.067200429,-0.902055047,-0.417427309
57,S57C,10,13,4,3,23,-0.451313511,-0.476086315,-0.463699913
58,L58Q,9,14,39,12,23,0.451776476,0.035797046,0.243786761
58,L58N,10,10,16,7,20,0.138157353,-0.117064372,0.01054649
58,L58A,23,34,27,34,57,-0.086342236,0.082704986,-0.001818625
58,L58I,20,14,17,9,34,-0.058867813,-0.242003109,-0.150435461
58,L58H,11,12,9,7,23,-0.150283516,-0.175056319,-0.162669917
58,L58C,25,26,13,23,51,-0.339947582,-0.033727166,-0.186837374
58,L58R,60,65,39,48,125,-0.268382828,-0.108109529,-0.188246178
58,L58E,18,25,24,8,43,-0.015584942,-0.387145231,-0.201365086
58,L58W,31,28,17,19,59,-0.292951019,-0.175056319,-0.234003669
58,L58G,68,61,29,53,129,-0.406894371,-0.079484657,-0.243189514
58,L58P,33,25,21,12,58,-0.198501605,-0.354843724,-0.276672664
58,L58V,57,49,27,28,106,-0.35229802,-0.264920844,-0.308609432
58,L58Y,18,30,12,12,48,-0.346325002,-0.274187792,-0.310256397
58,L58M,10,19,9,5,29,-0.247193529,-0.396905069,-0.322049299
58,L58T,21,27,17,7,48,-0.204995849,-0.485041157,-0.345018503
58,L58F,16,35,15,9,51,-0.281955635,-0.413938408,-0.347947021
58,L58K,14,15,5,6,29,-0.469042278,-0.329958279,-0.399500279
58,L58S,55,57,15,22,112,-0.619030735,-0.389285672,-0.504158203
58,L58D,23,33,4,13,56,-0.826977125,-0.307681884,-0.567329505
58,L58_,25,25,5,7,50,-0.6994912,-0.502415253,-0.600953226
59,Q59Y,10,11,22,4,21,0.249232881,-0.341387741,-0.04607743
59,Q59G,59,59,66,47,118,-0.019544433,-0.092240788,-0.05589261
59,Q59D,12,25,16,18,37,-0.119406949,0.00103494,-0.059186005
59,Q59W,19,31,28,14,50,-0.015244452,-0.229413981,-0.122329217
59,Q59M,19,13,9,12,32,-0.288586214,-0.102505652,-0.195545933
59,Q59I,23,16,21,6,39,-0.029709584,-0.454897016,-0.2423033
59,Q59C,17,26,27,5,43,0.033633081,-0.56323649,-0.264801705
59,Q59_,20,27,11,15,47,-0.372132265,-0.175056319,-0.273594292
59,Q59L,50,68,23,33,118,-0.465407994,-0.242003109,-0.353705551
59,Q59F,19,27,5,20,46,-0.664018881,-0.047813627,-0.355916254
59,Q59K,17,10,2,12,27,-0.74010905,-0.031149743,-0.385629397
59,Q59H,16,10,4,6,26,-0.502466034,-0.284200788,-0.393333411
59,Q59S,56,65,27,22,121,-0.409274073,-0.422567059,-0.415920566
59,Q59V,44,47,13,24,91,-0.587732065,-0.263782883,-0.425757474
59,Q59N,9,19,6,3,28,-0.387372232,-0.558273071,-0.472822651
59,Q59T,28,37,11,11,65,-0.510434963,-0.438297754,-0.474366359
59,Q59R,56,62,19,22,118,-0.54458924,-0.41175419,-0.478171715
59,Q59E,23,22,8,4,45,-0.478587596,-0.661722892,-0.570155244
59,Q59P,25,30,10,5,55,-0.476867616,-0.667971841,-0.572419728
59,Q59A,20,42,7,4,62,-0.666322836,-0.798305609,-0.732314223
60,N60E,11,12,22,23,23,0.21144432,0.302064936,0.256754628
60,N60K,10,16,25,11,26,0.21353731,-0.050117582,0.081709864
60,N60T,32,32,35,44,64,-0.02668313,0.142364093,0.057840482
60,N60F,26,42,43,31,68,0.034531312,-0.031634177,0.001448568
60,N60Y,26,22,26,17,48,-0.02890459,-0.132858639,-0.080881614
60,N60R,57,58,43,58,115,-0.191077587,0.008458958,-0.091309314
60,N60G,41,59,33,44,100,-0.242914731,-0.049043924,-0.145979327
60,N60M,26,25,16,21,51,-0.255626696,-0.071515727,-0.163571212
60,N60H,12,20,12,9,32,-0.174642861,-0.216449004,-0.195545933
60,N60L,70,74,48,47,144,-0.241244196,-0.178061829,-0.209653013
60,N60Q,13,17,3,22,30,-0.659373976,0.172431078,-0.243471449
60,N60S,55,56,31,36,111,-0.314140318,-0.178951363,-0.246545841
60,N60V,63,72,36,45,135,-0.335409458,-0.168716141,-0.2520628
60,N60A,49,39,26,22,88,-0.288098516,-0.285597235,-0.286847876
60,N60C,25,27,10,19,52,-0.452955458,-0.121180938,-0.287068198
60,N60D,13,29,8,15,42,-0.44929822,-0.127283537,-0.288290879
60,N60P,27,35,15,15,62,-0.365292841,-0.293155631,-0.329224236
60,N60W,17,31,13,10,48,-0.314140318,-0.346738459,-0.330439389
60,N60I,27,32,19,10,59,-0.247193529,-0.43469363,-0.340943579
60,N60_,20,27,3,7,47,-0.84925352,-0.476086315,-0.662669917
61,R61P,29,30,16,73,59,-0.317774603,0.393145405,0.037685401
61,R61S,56,61,30,50,117,-0.350592587,-0.062246895,-0.206419741
61,R61Y,29,28,22,15,57,-0.171772431,-0.257243075,-0.214507753
61,R61C,24,26,14,17,50,-0.301551191,-0.150232735,-0.225891963
61,R61Q,12,15,5,12,27,-0.439079055,-0.031149743,-0.235114399
61,R61F,41,26,24,17,67,-0.204641178,-0.275171472,-0.239906325
61,R61V,50,63,27,38,113,-0.379819094,-0.163775309,-0.271797201
61,R61H,21,17,7,12,38,-0.458046894,-0.175056319,-0.316551606
61,R61_,26,24,13,11,50,-0.331514414,-0.326323994,-0.328919204
61,R61K,24,21,16,7,45,-0.202381184,-0.457602909,-0.329992047
61,R61T,36,34,15,19,70,-0.41721064,-0.248163417,-0.332687029
61,R61G,66,53,24,30,119,-0.451313511,-0.285754617,-0.368534064
61,R61A,30,50,28,11,80,-0.216159295,-0.527238837,-0.371699066
61,R61N,25,14,11,5,39,-0.292951019,-0.521843805,-0.407397412
61,R61L,76,71,29,31,147,-0.463212735,-0.363046801,-0.413129768
61,R61I,21,19,5,11,40,-0.60470488,-0.231537675,-0.418121278
61,R61D,13,28,6,9,41,-0.548223524,-0.321184355,-0.434703939
61,R61E,18,18,6,6,36,-0.493175958,-0.421038748,-0.457107353
61,R61M,29,17,8,7,46,-0.487927622,-0.466942935,-0.477435279
61,R61W,21,34,9,7,55,-0.518260301,-0.543033104,-0.530646703
62,N62M,18,14,19,18,32,0.012443782,0.062304597,0.037374189
62,N62T,18,27,30,20,45,0.058531588,-0.038473601,0.010028994
62,N62I,13,14,19,9,27,0.08379969,-0.145093096,-0.030646703
62,N62E,12,21,15,15,33,-0.097431208,-0.025293999,-0.061362603
62,N62A,26,25,30,18,51,0.005286076,-0.135184807,-0.064949365
62,N62V,41,35,31,34,76,-0.151413021,-0.040357745,-0.095885383
62,N62D,16,15,13,12,31,-0.129094216,-0.08914169,-0.109117953
62,N62S,52,60,33,49,112,-0.2916718,-0.052043503,-0.171857652
62,N62R,66,65,40,55,131,-0.277862348,-0.070320968,-0.174091658
62,N62Q,17,22,13,13,39,-0.226004229,-0.15386702,-0.189935625
62,N62Y,15,15,20,4,30,0.060785327,-0.490326754,-0.214770713
62,N62W,20,27,10,20,47,-0.409920826,-0.056957007,-0.233438916
62,N62G,47,42,28,25,89,-0.261916785,-0.237204226,-0.249560506
62,N62H,15,17,5,15,32,-0.510434963,-0.012329022,-0.261381992
62,N62F,18,30,13,13,48,-0.314140318,-0.242003109,-0.278071713
62,N62P,29,26,11,18,55,-0.439079055,-0.16736949,-0.303224273
62,N62_,16,15,7,7,31,-0.372132265,-0.299995056,-0.33606366
62,N62L,48,60,33,20,108,-0.276019855,-0.413142267,-0.344581061
62,N62K,25,24,13,3,49,-0.322914242,-0.794845077,-0.55887966
62,N62C,21,20,6,4,41,-0.548223524,-0.62221435,-0.585218937
63,G63E,7,12,17,93,19,0.184170236,0.974162794,0.579166515
63,G63L,45,52,388,89,97,0.828651252,0.265081369,0.546866311
63,G63R,55,60,379,89,115,0.745253334,0.191849456,0.468551395
63,G63A,26,34,105,57,60,0.469903756,0.280163094,0.375033425
63,G63Q,8,14,29,21,22,0.345321145,0.282759781,0.314040463
63,G63K,10,12,24,16,22,0.266139899,0.170786021,0.21846296
63,G63M,16,8,20,21,24,0.154207012,0.246547608,0.20037731
63,G63Y,18,13,25,24,31,0.139751096,0.194854966,0.167303031
63,G63N,15,15,28,16,30,0.20096403,0.041152163,0.121058097
63,G63C,23,27,41,29,50,0.14560684,0.071616014,0.108611427
63,G63W,11,12,31,7,23,0.354866463,-0.175056319,0.089905072
63,G63F,29,31,62,23,60,0.243938441,-0.103053658,0.070442392
63,G63P,14,14,12,20,28,-0.118526919,0.161886233,0.021679657
63,G63D,12,14,12,14,26,-0.087492686,0.046792431,-0.020350128
63,G63V,40,49,30,43,89,-0.232953089,-0.008724897,-0.120838993
63,G63T,17,28,14,18,45,-0.256738846,-0.081939295,-0.169339071
63,G63H,14,19,13,10,33,-0.155423155,-0.188021296,-0.171722226
63,G63S,45,55,42,30,100,-0.140925192,-0.210894744,-0.175909968
63,G63I,29,27,11,33,56,-0.446765883,0.077668997,-0.184548443
63,G63_,15,24,9,6,39,-0.372132265,-0.454897016,-0.41351464
64,K64Q,4,5,5,15,9,0.008078977,0.506184918,0.257131947
64,K64R,48,50,65,78,98,0.053836467,0.204056832,0.12894665
64,K64N,18,28,51,13,46,0.273833212,-0.223904887,0.024964163
64,K64L,32,51,40,39,83,-0.081567703,-0.020154359,-0.050861031
64,K64Y,13,8,6,12,21,-0.267396915,0.073585607,-0.096905654
64,K64_,7,7,5,6,14,-0.168012282,-0.028928283,-0.098470283
64,K64G,50,47,30,52,97,-0.269936656,0.03511473,-0.117410963
64,K64A,24,33,22,23,57,-0.171772431,-0.081151816,-0.126462124
64,K64V,29,56,40,22,85,-0.091786868,-0.27070568,-0.181246274
64,K64S,42,57,30,38,99,-0.27871058,-0.106870457,-0.192790519
64,K64C,28,22,21,13,50,-0.135219769,-0.259377205,-0.197298487
64,K64T,33,37,21,20,70,-0.278907942,-0.226974118,-0.25294103
64,K64P,35,28,14,24,63,-0.400160989,-0.10617503,-0.253168009
64,K64D,6,10,5,3,16,-0.222369945,-0.326323994,-0.27434697
64,K64F,35,50,26,17,85,-0.273206961,-0.37716101,-0.325183986
64,K64I,25,25,23,5,50,-0.097431208,-0.62735399,-0.362392599
64,K64W,27,29,17,8,56,-0.270674624,-0.499567411,-0.385121017
64,K64E,9,3,1,3,12,-0.58298563,-0.209818425,-0.396402028
64,K64M,8,12,3,4,20,-0.490231577,-0.321184355,-0.405707966
64,K64H,12,10,9,1,22,-0.13180011,-0.758632905,-0.445216507
65,W65K,13,17,34,33,30,0.282634077,0.342182159,0.312408118
65,W65G,46,63,90,61,109,0.147576433,0.05306394,0.100320187
65,W65E,15,14,15,19,29,-0.043073546,0.125973677,0.041450065
65,W65R,38,47,53,47,85,0.027823035,0.048807722,0.038315378
65,W65P,34,44,45,44,78,-0.004941533,0.057650358,0.026354412
65,W65Y,16,24,19,20,40,-0.081826135,0.011500374,-0.035162881
65,W65N,16,25,28,14,41,0.069076434,-0.145093096,-0.038008331
65,W65_,20,31,16,29,51,-0.255626696,0.063182847,-0.096221925
65,W65S,67,69,61,52,136,-0.114401151,-0.110379762,-0.112390457
65,W65D,15,26,22,10,41,-0.031593728,-0.27979167,-0.155692699
65,W65H,17,19,7,21,36,-0.435184011,0.076285892,-0.179449059
65,W65L,64,92,48,61,156,-0.275775846,-0.101443027,-0.188609437
65,W65A,38,39,14,41,77,-0.486075617,0.033219623,-0.226427997
65,W65C,26,32,10,23,58,-0.4995316,-0.088575834,-0.294053717
65,W65T,28,40,22,14,68,-0.247193529,-0.360692896,-0.303943212
65,W65V,47,71,37,25,118,-0.265835639,-0.358508678,-0.312172158
65,W65I,17,18,5,13,35,-0.548223524,-0.108109529,-0.328166527
65,W65Q,20,18,15,5,38,-0.157016898,-0.510848421,-0.33393266
65,W65F,22,30,11,10,52,-0.415166897,-0.380818249,-0.397992573
65,W65M,19,29,10,9,48,-0.418875669,-0.388131144,-0.403503407
66,R66D,25,20,61,32,45,0.359561584,0.157821044,0.258691314
66,R66M,23,34,35,89,57,0.022802233,0.492879452,0.257840842
66,R66T,46,55,144,65,101,0.382695557,0.113008699,0.247852128
66,R66I,13,30,34,37,43,0.130543094,0.238395856,0.184469475
66,R66F,35,30,44,64,65,0.063596304,0.295434357,0.179515331
66,R66N,28,18,28,47,46,0.020227866,0.311208315,0.165718091
66,R66L,85,103,156,109,188,0.149365574,0.066995817,0.108180696
66,R66Y,25,36,33,46,61,-0.030985046,0.181771104,0.075393029
66,R66S,79,100,119,97,179,0.053836467,0.038018506,0.045927487
66,R66C,38,33,32,56,71,-0.10889083,0.200607295,0.045858232
66,R66W,48,50,58,57,98,0.005144543,0.069857735,0.037501139
66,R66H,25,18,27,23,43,0.033633081,0.038823501,0.036228291
66,R66A,39,54,71,41,93,0.114132369,-0.047813627,0.033159371
66,R66V,65,69,78,77,134,-0.002778951,0.06382577,0.030523409
66,R66Q,27,32,53,19,59,0.184170236,-0.175056319,0.004556958
66,R66P,40,42,42,47,82,-0.055681911,0.064228081,0.004273085
66,R66E,21,26,27,17,47,-0.00415548,-0.123903797,-0.064029638
66,R66_,38,43,40,30,81,-0.071102269,-0.120387223,-0.095744746
66,R66G,72,64,88,35,136,0.042597166,-0.278353131,-0.117877983
66,R66K,17,33,33,10,50,0.053836467,-0.364112555,-0.155138044
67,E67V,51,50,126,49,101,0.325131275,-0.007565232,0.158783022
67,E67S,68,82,162,84,150,0.263138383,0.052506914,0.157822649
67,E67I,16,21,22,27,37,0.011871966,0.16943937,0.090655668
67,E67H,24,16,20,27,40,-0.060636836,0.13643911,0.037901137
67,E67G,61,76,57,109,137,-0.146523367,0.203578534,0.028527584
67,E67T,36,40,39,48,76,-0.054503008,0.105770291,0.025633641
67,E67R,83,90,77,122,173,-0.118526919,0.151420799,0.01644694
67,E67W,22,36,30,32,58,-0.049562592,0.049726864,8.21E-05
67,E67C,22,39,36,21,61,0.005737761,-0.147904073,-0.071083156
67,E67P,39,33,36,29,72,-0.06519341,-0.08413667,-0.07466504
67,E67Q,24,26,13,34,50,-0.331514414,0.138562804,-0.096475805
67,E67D,25,19,16,21,44,-0.192835866,-0.008724897,-0.100780382
67,E67A,56,54,46,45,110,-0.143297395,-0.080500211,-0.111898803
67,E67Y,19,24,23,13,43,-0.033313709,-0.195259705,-0.114286707
67,E67F,14,20,20,9,34,0.008078977,-0.242003109,-0.116962066
67,E67N,14,20,10,15,34,-0.272747633,-0.037883126,-0.15531538
67,E67_,28,27,21,16,55,-0.17583762,-0.21567417,-0.195755895
67,E67M,28,23,12,20,51,-0.372132265,-0.091719113,-0.231925689
67,E67K,28,34,18,20,62,-0.290659222,-0.175056319,-0.232857771
67,E67L,56,54,32,34,110,-0.296881313,-0.199189999,-0.248035656
68,Q68K,6,4,13,20,10,0.334663077,0.582891545,0.458777311
68,Q68R,24,23,53,50,47,0.281080249,0.328393874,0.304737062
68,Q68Y,14,16,27,19,30,0.185724064,0.111733238,0.148728651
68,Q68A,36,44,115,30,80,0.385900697,-0.115058389,0.135421154
68,Q68I,25,41,63,29,66,0.210032897,-0.046888612,0.081572143
68,Q68L,55,70,64,90,125,-0.057529462,0.160735783,0.05160316
68,Q68V,36,57,49,64,93,-0.044230123,0.141850439,0.048810158
68,Q68M,14,27,18,32,41,-0.114567963,0.197329585,0.041380811
68,Q68G,6,14,11,8,20,-0.013110323,-0.06591185,-0.039511086
68,Q68S,45,48,51,40,93,-0.027196784,-0.058279061,-0.042737922
68,Q68P,29,39,32,31,68,-0.090407425,-0.031634177,-0.061020801
68,Q68W,11,11,8,10,22,-0.1775576,-0.018270215,-0.097913908
68,Q68F,16,42,24,19,58,-0.142984277,-0.16775708,-0.155370679
68,Q68H,21,19,10,20,40,-0.341463445,0.011500374,-0.164981536
68,Q68_,6,9,3,7,15,-0.372132265,0.00103494,-0.185548663
68,Q68T,34,42,25,25,76,-0.241589651,-0.169452441,-0.205521046
68,Q68N,18,19,8,12,37,-0.395613361,-0.163775309,-0.279694335
68,Q68D,13,24,12,7,37,-0.235912518,-0.374628674,-0.305270596
68,Q68C,15,19,7,6,34,-0.411050331,-0.396905069,-0.4039777
68,Q68E,11,5,3,0,16,-0.398461204,-0.928383986,-0.663422595
69,L69M,32,22,39,65,54,0.091625028,0.381246182,0.236435605
69,L69S,64,98,134,158,162,0.14807389,0.291274456,0.219674173
69,L69E,28,36,58,51,64,0.187866381,0.205154923,0.196510652
69,L69P,35,42,54,76,77,0.078195813,0.296461058,0.187328436
69,L69C,34,54,108,46,88,0.317964217,0.024772787,0.171368502
69,L69H,22,14,40,19,36,0.274509859,0.034893207,0.154701533
69,L69A,57,63,146,48,120,0.314459691,-0.090524355,0.111967668
69,L69K,28,43,48,47,71,0.06279131,0.125973677,0.094382493
69,L69D,26,34,44,36,60,0.097810405,0.084936825,0.091373615
69,L69Q,26,13,36,18,39,0.196069459,-0.021241455,0.087414002
69,L69Y,23,25,24,35,48,-0.062328345,0.168171356,0.052921506
69,L69V,59,71,77,70,130,0.004751033,0.036051989,0.020401511
69,L69_,23,30,48,17,53,0.187730046,-0.175056319,0.006336864
69,L69W,31,37,39,35,68,-0.006861373,0.019518346,0.006328486
69,L69I,27,23,31,23,50,0.027507528,-0.025293999,0.001106765
69,L69G,76,92,90,81,168,-0.038917586,-0.012007917,-0.025462751
69,L69R,91,113,107,67,204,-0.048402379,-0.177180013,-0.112791196
69,L69T,54,63,53,40,117,-0.109560521,-0.157033215,-0.133296868
69,L69N,26,26,19,20,52,-0.193318148,-0.099991639,-0.146654893
69,L69F,49,24,21,17,73,-0.296881313,-0.311894279,-0.304387796
70,G70L,65,83,319,214,148,0.561891436,0.461317127,0.511604282
70,G70W,17,23,48,89,40,0.307339949,0.643523588,0.475431769
70,G70A,30,41,62,130,71,0.171935779,0.562003735,0.366969757
70,G70R,74,89,189,181,163,0.293837479,0.347292476,0.320564977
70,G70C,31,38,66,84,69,0.210904489,0.386385821,0.298645155
70,G70T,31,27,72,50,58,0.322398575,0.2387831,0.280590837
70,G70Q,31,24,35,88,55,0.0380422,0.503266915,0.270654558
70,G70V,50,66,116,101,116,0.229927726,0.242479246,0.236203486
70,G70D,22,14,31,27,36,0.16687598,0.181021243,0.173948612
70,G70M,20,32,58,26,52,0.276503868,0.00915283,0.142828349
70,G70K,17,24,55,16,41,0.354866463,-0.090735433,0.132065515
70,G70N,18,18,18,34,36,-0.059520397,0.277931256,0.10920543
70,G70S,69,68,113,78,137,0.146953491,0.059812941,0.103383216
70,G70F,30,39,43,41,69,0.028282363,0.080216186,0.054249274
70,G70P,35,39,24,57,74,-0.247193529,0.190431666,-0.028380931
70,G70I,24,29,33,19,53,0.029012883,-0.129298828,-0.050142973
70,G70Y,27,28,17,33,55,-0.262987796,0.085355826,-0.088815985
70,G70E,18,17,20,11,35,-0.00415548,-0.175056319,-0.089605899
70,G70H,20,27,17,23,47,-0.196041006,0.00103494,-0.097503033
70,G70_,24,22,11,8,46,-0.362988886,-0.415790413,-0.389389649
71,Q71R,61,55,139,56,116,0.3078699,-0.01024607,0.148811915
71,Q71M,12,21,26,15,33,0.129812573,-0.025293999,0.052259287
71,Q71L,61,63,88,64,124,0.08240772,0.018068279,0.050238
71,Q71N,15,21,9,39,36,-0.338273998,0.335923203,-0.001175397
71,Q71T,36,29,38,26,65,0.001448398,-0.086115236,-0.042333419
71,Q71F,16,28,31,13,44,0.081865191,-0.205019542,-0.061577176
71,Q71Y,16,15,18,9,31,0.003531349,-0.203085043,-0.099776847
71,Q71K,3548,3924,3438,2633,7472,-0.10713508,-0.150814276,-0.128974678
71,Q71S,45,61,36,45,106,-0.231254327,-0.06456101,-0.147907669
71,Q71G,38,49,24,32,87,-0.316614937,-0.123903797,-0.220259367
71,Q71H,14,16,10,8,30,-0.220041283,-0.235054249,-0.227547766
71,Q71I,12,23,18,6,35,-0.047621174,-0.409139525,-0.228380349
71,Q71_,11,19,6,13,30,-0.416335928,-0.043168722,-0.229752325
71,Q71W,27,23,16,14,50,-0.247193529,-0.229413981,-0.238303755
71,Q71P,33,36,36,11,69,-0.04696859,-0.463851858,-0.255410224
71,Q71D,24,33,11,23,57,-0.454319021,-0.081151816,-0.267735419
71,Q71A,36,47,20,21,83,-0.372132265,-0.27979167,-0.325961967
71,Q71V,45,67,42,18,112,-0.189682262,-0.472259907,-0.330971084
71,Q71C,32,23,9,18,55,-0.518260301,-0.16736949,-0.342814896
71,Q71E,13,29,8,4,42,-0.44929822,-0.632433516,-0.540865868
72,K72P,21,26,38,110,47,0.139751096,0.666146677,0.402948886
72,K72E,20,16,68,14,36,0.500575093,-0.090045529,0.205264782
72,K72S,72,65,48,110,137,-0.21975528,0.207508828,-0.006123226
72,K72R,55,58,41,71,113,-0.203727835,0.102492581,-0.050617627
72,K72I,14,16,13,14,30,-0.115305932,-0.013205499,-0.064255716
72,K72G,48,38,37,38,86,-0.12980793,-0.04638971,-0.08809882
72,K72L,59,56,69,32,115,0.010567777,-0.243879114,-0.116655668
72,K72Q,26,14,15,13,40,-0.178736148,-0.164590885,-0.171663517
72,K72M,20,20,17,9,40,-0.127583625,-0.310718921,-0.219151273
72,K72W,17,30,23,7,47,-0.071102269,-0.476086315,-0.273594292
72,K72H,20,17,8,9,37,-0.395613361,-0.277718661,-0.336666011
72,K72A,36,33,10,25,69,-0.573777629,-0.128059756,-0.350918693
72,K72Y,15,19,6,8,34,-0.469042278,-0.287760599,-0.378401439
72,K72C,23,25,10,9,48,-0.418875669,-0.388131144,-0.403503407
72,K72F,21,20,5,12,41,-0.615170314,-0.207241002,-0.411205658
72,K72N,21,28,12,7,49,-0.355098926,-0.493815082,-0.424457004
72,K72D,23,8,9,3,31,-0.275222252,-0.601025051,-0.438123652
72,K72T,31,31,12,10,62,-0.455469471,-0.455882929,-0.4556762
72,K72_,26,24,5,10,50,-0.6994912,-0.364112555,-0.531801877
72,K72V,19,19,8,1,38,-0.406894371,-0.987969676,-0.697432024
73,F73Y,23,22,25,26,45,-0.017856758,0.070670868,0.026407055
73,F73I,24,19,19,20,43,-0.112494955,-0.019168446,-0.0658317
73,F73V,50,56,49,46,106,-0.100486047,-0.055220984,-0.077853516
73,F73_,17,26,20,17,43,-0.091305656,-0.086115236,-0.088710446
73,F73D,18,21,13,19,39,-0.226004229,0.00103494,-0.112484645
73,F73N,19,21,19,12,40,-0.081826135,-0.196775569,-0.139300852
73,F73H,15,19,17,9,34,-0.058867813,-0.242003109,-0.150435461
73,F73G,67,62,44,35,129,-0.230803112,-0.255575916,-0.243189514
73,F73L,58,58,47,24,116,-0.157016898,-0.368180917,-0.262598908
73,F73P,28,38,14,25,66,-0.420055817,-0.109036519,-0.264546168
73,F73E,28,31,7,36,59,-0.645133537,0.092115409,-0.276509064
73,F73R,58,77,41,34,135,-0.280361892,-0.287405928,-0.28388391
73,F73K,30,28,12,19,58,-0.426980933,-0.16775708,-0.297369007
73,F73W,31,33,25,11,64,-0.168012282,-0.431667175,-0.299839729
73,F73S,56,67,26,35,123,-0.432130195,-0.235054249,-0.333592222
73,F73A,44,43,14,30,87,-0.538463687,-0.151056043,-0.344759865
73,F73T,35,41,11,28,76,-0.577381753,-0.122027792,-0.349704772
73,F73M,26,36,17,10,62,-0.314140318,-0.455882929,-0.385011623
73,F73Q,22,19,8,8,41,-0.439079055,-0.366941845,-0.40301045
73,F73C,23,47,17,11,70,-0.366058117,-0.470012167,-0.418035142
74,E74H,17,12,20,26,29,0.075025766,0.256307445,0.165666606
74,E74F,25,25,29,35,50,-0.000521195,0.15079726,0.075138033
74,E74A,39,43,68,33,82,0.149698725,-0.08553424,0.032082242
74,E74I,24,28,55,15,52,0.253839884,-0.218090951,0.017874466
74,E74V,52,54,76,41,106,0.087034674,-0.104069552,-0.008517439
74,E74M,10,27,14,23,37,-0.173764611,0.102492581,-0.035636015
74,E74Y,35,30,22,43,65,-0.227888373,0.125973677,-0.050957348
74,E74Q,20,13,13,16,33,-0.155423155,0.00103494,-0.077194108
74,E74W,33,30,29,25,63,-0.099130993,-0.08914169,-0.094136342
74,E74L,64,64,65,47,128,-0.061118049,-0.127283537,-0.094200793
74,E74R,71,80,52,72,151,-0.227639992,-0.016455792,-0.122047892
74,E74K,24,22,20,15,46,-0.119950837,-0.16591294,-0.142931888
74,E74D,20,20,11,16,40,-0.303674884,-0.08027,-0.191972442
74,E74P,28,41,18,27,69,-0.336416713,-0.095875073,-0.216145893
74,E74S,67,67,56,31,134,-0.144531187,-0.323118854,-0.233825021
74,E74N,22,15,8,13,37,-0.395613361,-0.131590625,-0.263601993
74,E74C,27,39,34,9,66,-0.052079032,-0.524009867,-0.28804445
74,E74T,42,52,30,20,94,-0.256434185,-0.353439375,-0.30493678
74,E74G,61,87,54,26,148,-0.202895853,-0.439757569,-0.321326711
74,E74_,17,34,5,23,51,-0.707924367,-0.033727166,-0.370825767
75,E75K,16,21,75,39,37,0.530957722,0.32434133,0.427649526
75,E75R,75,76,163,173,151,0.262927986,0.360770596,0.311849291
75,E75C,25,26,47,59,51,0.19516562,0.364212842,0.279689231
75,E75H,18,21,27,49,39,0.075025766,0.398974949,0.237000357
75,E75W,22,28,41,44,50,0.14560684,0.247707273,0.196657057
75,E75A,54,32,76,58,86,0.176899199,0.133397695,0.155148447
75,E75S,55,76,96,84,131,0.096125529,0.11090993,0.10351773
75,E75F,21,26,25,39,47,-0.036340163,0.22288369,0.093271763
75,E75Y,18,20,19,33,38,-0.060106885,0.242479246,0.09118618
75,E75T,36,41,62,42,77,0.137173673,0.043438789,0.090306231
75,E75L,60,67,90,77,127,0.081759149,0.086949569,0.084354359
75,E75G,40,55,58,66,95,0.018508505,0.145868505,0.082188505
75,E75M,18,23,50,12,41,0.314248612,-0.207241002,0.053503805
75,E75I,23,24,32,24,47,0.067200429,0.018763707,0.042982068
75,E75N,17,15,19,17,32,0.012443782,0.038823501,0.025633641
75,E75Q,15,20,21,18,35,0.016047906,0.024516036,0.020281971
75,E75V,48,55,61,40,103,0.005286076,-0.102184547,-0.048449235
75,E75P,28,28,18,36,56,-0.247193529,0.114391804,-0.066400862
75,E75D,16,22,8,15,38,-0.406894371,-0.084879689,-0.24588703
75,E75_,16,21,7,5,37,-0.446765883,-0.499567411,-0.473166647
76,I76Y,22,18,27,101,40,0.064301901,0.697881251,0.381091576
76,I76F,26,30,133,37,56,0.601157669,0.125973677,0.363565673
76,I76K,22,12,37,22,34,0.265643278,0.119724727,0.192684003
76,I76P,21,23,52,24,44,0.300991082,0.046792431,0.173891756
76,I76N,14,19,49,12,33,0.397418813,-0.115470629,0.140974092
76,I76A,22,34,37,44,56,0.053836467,0.199402594,0.12661953
76,I76R,52,55,113,52,107,0.253408822,-0.00708295,0.123162936
76,I76D,21,26,42,25,47,0.182154944,0.035797046,0.108975995
76,I76G,48,40,55,63,88,0.028725747,0.158854903,0.093790325
76,I76E,8,22,19,20,30,0.039596028,0.132922537,0.086259282
76,I76H,14,22,20,26,36,-0.016054703,0.165226976,0.074586136
76,I76V,49,40,50,42,89,-0.016744607,-0.018709118,-0.017726863
76,I76S,54,67,54,68,121,-0.116069415,0.054554196,-0.03075761
76,I76_,22,24,23,21,46,-0.06195889,-0.027610241,-0.044784566
76,I76W,26,21,31,15,47,0.053836467,-0.175056319,-0.060609926
76,I76C,28,37,40,22,65,0.023167647,-0.155751164,-0.066291758
76,I76L,57,57,58,40,114,-0.059918103,-0.145849048,-0.102883575
76,I76Q,18,22,21,11,40,-0.04043345,-0.231537675,-0.135985562
76,I76M,26,24,25,12,50,-0.062669102,-0.291561888,-0.177115495
76,I76T,27,30,8,14,57,-0.579257758,-0.285271799,-0.432264778
77,R77M,21,23,37,34,44,0.156498809,0.192920466,0.174709638
77,R77L,57,79,117,75,136,0.165089166,0.046157961,0.105623564
77,R77S,65,65,89,74,130,0.06689894,0.059854903,0.063376922
77,R77C,32,21,37,28,53,0.077317563,0.032069174,0.054693368
77,R77G,41,54,73,42,95,0.116888213,-0.046737842,0.035075186
77,R77I,23,21,12,48,44,-0.309341435,0.339048502,0.014853533
77,R77V,52,49,74,41,101,0.096388818,-0.083285946,0.006551436
77,R77A,28,36,28,43,64,-0.120587633,0.132604256,0.006008311
77,R77N,21,16,24,16,37,0.048084138,-0.04726974,0.000407199
77,R77P,42,32,38,41,74,-0.05406893,0.050252963,-0.001907984
77,R77W,12,31,22,23,43,-0.051797114,0.038823501,-0.006486807
77,R77F,29,23,19,37,52,-0.193318148,0.157572663,-0.017872743
77,R77D,19,14,11,21,33,-0.222369945,0.113008699,-0.054680623
77,R77E,13,22,14,13,35,-0.150283516,-0.108109529,-0.129196522
77,R77K,17,16,12,13,33,-0.187607839,-0.083285946,-0.135446892
77,R77T,52,40,38,33,92,-0.147490615,-0.134939096,-0.141214856
77,R77H,21,26,22,13,47,-0.089585675,-0.233048266,-0.161316971
77,R77Q,15,27,17,13,42,-0.148268224,-0.185275484,-0.166771854
77,R77_,23,24,11,22,47,-0.372132265,-0.017448466,-0.194790365
77,R77Y,24,28,16,10,52,-0.263899222,-0.380818249,-0.322358735
78,W78H,18,19,45,58,37,0.312901961,0.493133351,0.403017656
78,W78Y,20,21,40,19,41,0.219462292,-0.020154359,0.099653967
78,W78F,28,32,25,27,60,-0.140428761,-0.036106868,-0.088267814
78,W78R,55,68,60,45,123,-0.078164124,-0.128598918,-0.103381521
78,W78P,39,27,28,25,66,-0.133749079,-0.109036519,-0.121392799
78,W78C,27,17,15,15,44,-0.219164805,-0.147027595,-0.1830962
78,W78I,24,24,21,7,48,-0.117845673,-0.485041157,-0.301443415
78,W78M,26,26,28,5,52,-0.031950146,-0.644059684,-0.338004915
78,W78L,72,82,39,36,154,-0.358343981,-0.320065038,-0.33920451
78,W78G,46,62,16,42,108,-0.57704985,-0.101893107,-0.339471479
78,W78E,23,19,12,7,42,-0.289597377,-0.428313533,-0.358955455
78,W78V,37,64,28,19,101,-0.316274448,-0.40550524,-0.360889844
78,W78N,19,25,12,7,44,-0.309341435,-0.448057591,-0.378699513
78,W78_,22,24,5,12,46,-0.664018881,-0.25608957,-0.460054226
78,W78T,32,42,8,17,74,-0.690891028,-0.317723823,-0.504307425
78,W78Q,24,23,8,5,47,-0.497071002,-0.601025051,-0.549048027
78,W78D,16,20,4,5,36,-0.639303994,-0.487985538,-0.563644766
78,W78A,31,39,11,8,70,-0.542149376,-0.594950904,-0.56855014
78,W78S,62,66,21,14,128,-0.538239303,-0.632433516,-0.585336409
78,W78K,18,20,2,9,38,-0.884015626,-0.288999671,-0.586507649
79,L79H,17,17,48,67,34,0.376055762,0.590505804,0.483280783
79,L79R,65,79,277,193,144,0.51260452,0.428498663,0.470551592
79,L79K,29,19,77,77,48,0.431826249,0.503963458,0.467894854
79,L79A,28,37,85,78,65,0.344882242,0.380148091,0.362515167
79,L79C,23,20,63,44,43,0.392655024,0.311824773,0.352239898
79,L79M,20,30,77,39,50,0.414452153,0.196554751,0.305503452
79,L79Y,23,26,84,26,49,0.460376648,0.034458696,0.247417672
79,L79N,25,11,32,37,36,0.180239942,0.313646808,0.246943375
79,L79V,57,51,99,91,108,0.192501228,0.228426265,0.210463747
79,L79W,22,36,55,43,58,0.207263742,0.174665601,0.190964671
79,L79Q,11,17,31,16,28,0.272679707,0.070115859,0.171397783
79,L79P,23,23,38,34,46,0.148894475,0.174035122,0.161464799
79,L79F,32,23,40,39,55,0.094523556,0.1559369,0.125230228
79,L79G,60,63,94,64,123,0.114229646,0.021556607,0.067893127
79,L79D,13,20,17,22,33,-0.046278686,0.132313855,0.043017584
79,L79S,54,71,78,65,125,0.027184272,0.021238326,0.024211299
79,L79T,31,35,39,35,66,0.005912915,0.032292634,0.019102774
79,L79I,16,31,19,32,47,-0.150283516,0.139337638,-0.005472939
79,L79E,24,31,27,28,55,-0.071102269,0.016274907,-0.027413681
79,L79_,19,22,8,2,41,-0.439079055,-0.8440631,-0.641571077
80,I80D,20,18,21,39,38,-0.0187142,0.31306032,0.14717306
80,I80P,28,37,52,38,65,0.13465966,0.073585607,0.104122634
80,I80M,17,26,36,23,43,0.154676774,0.038823501,0.096750137
80,I80A,30,41,58,35,71,0.143447241,0.00103494,0.072241091
80,I80_,27,39,59,29,66,0.182004174,-0.046888612,0.067557781
80,I80W,32,40,51,37,72,0.08260821,0.018525672,0.050566941
80,I80H,16,20,16,25,36,-0.107825077,0.14883656,0.020505742
80,I80F,36,25,26,36,61,-0.131100199,0.07787497,-0.026612614
80,I80V,60,58,45,68,118,-0.182861404,0.065367065,-0.058747169
80,I80C,24,33,38,16,57,0.05756434,-0.230914136,-0.086674898
80,I80Q,21,25,15,21,46,-0.238050149,-0.027610241,-0.132830195
80,I80N,23,18,22,11,41,-0.031593728,-0.242003109,-0.136798418
80,I80L,69,88,67,49,157,-0.136220448,-0.197622147,-0.166921297
80,I80G,52,51,48,27,103,-0.096909533,-0.267810372,-0.182359953
80,I80T,34,32,21,23,66,-0.253724396,-0.143798625,-0.19876151
80,I80E,19,23,17,9,42,-0.148268224,-0.33140352,-0.239835872
80,I80Y,32,22,21,10,54,-0.168012282,-0.396905069,-0.282458676
80,I80S,47,75,29,38,122,-0.382856131,-0.196775569,-0.28981585
80,I80R,90,92,27,39,182,-0.585365332,-0.358326163,-0.471845747
80,I80K,24,21,2,3,45,-0.955708851,-0.758632905,-0.857170878
81,E81C,18,32,290,29,50,0.986250539,0.071616014,0.528933277
81,E81W,22,38,85,64,60,0.379096342,0.329648457,0.3543724
81,E81I,17,23,34,46,40,0.161211914,0.361378937,0.261295425
81,E81M,35,20,62,36,55,0.281080249,0.122078633,0.201579441
81,E81R,59,67,297,26,126,0.600340269,-0.370375021,0.114982624
81,E81L,61,50,88,68,111,0.13009971,0.091696004,0.110897857
81,E81Y,18,34,35,33,52,0.061954357,0.109267983,0.08561117
81,E81V,39,42,73,38,81,0.185345594,-0.02068431,0.082330642
81,E81F,32,37,44,41,69,0.0380422,0.080216186,0.059129193
81,E81H,17,15,27,14,32,0.158571818,-0.040357745,0.059107036
81,E81_,14,22,18,22,36,-0.059520397,0.095591048,0.018035325
81,E81S,63,66,57,74,129,-0.120587633,0.063182847,-0.028702393
81,E81T,37,36,35,31,73,-0.083001493,-0.062016806,-0.072509149
81,E81Q,13,28,19,12,41,-0.092291569,-0.207241002,-0.149766285
81,E81N,25,22,21,14,47,-0.10889083,-0.203085043,-0.155987936
81,E81D,18,22,19,9,40,-0.081826135,-0.310718921,-0.196272528
81,E81G,54,48,38,19,102,-0.191844892,-0.409742293,-0.300793592
81,E81A,37,41,15,27,78,-0.463579382,-0.148404124,-0.305991753
81,E81K,30,23,13,12,53,-0.356337998,-0.316385472,-0.336361735
81,E81P,33,34,14,7,67,-0.426489927,-0.62735399,-0.526921959
82,E82R,51,77,355,219,128,0.670788014,0.533897906,0.60234296
82,E82I,23,31,203,37,54,0.799195204,0.141485843,0.470340523
82,E82S,50,64,170,179,114,0.402225996,0.4966396,0.449432798
82,E82L,56,77,191,177,133,0.386124157,0.42538014,0.405752148
82,E82C,17,32,55,62,49,0.279145749,0.402435481,0.340790615
82,E82H,14,15,27,24,29,0.199964503,0.22288369,0.211424096
82,E82T,27,45,82,47,72,0.285682958,0.119983313,0.202833136
82,E82V,65,62,151,76,127,0.304561344,0.081345691,0.192953518
82,E82G,47,38,59,73,85,0.073580525,0.236798204,0.155189365
82,E82M,18,19,35,18,37,0.20644663,0.00103494,0.103740785
82,E82D,27,20,36,26,47,0.116888213,0.052187462,0.084537838
82,E82W,25,26,44,22,51,0.167136896,-0.052210572,0.057463162
82,E82N,18,27,42,15,45,0.20063835,-0.156572913,0.022032718
82,E82F,36,31,34,39,67,-0.058513142,0.071616014,0.006551436
82,E82K,24,18,28,16,42,0.058857268,-0.100954598,-0.021048665
82,E82P,23,19,16,26,42,-0.173091808,0.099960244,-0.036565782
82,E82Q,13,17,14,12,30,-0.085342709,-0.075353406,-0.080348057
82,E82A,35,40,41,26,75,-0.027636576,-0.147384892,-0.087510734
82,E82Y,16,27,8,15,43,-0.459282441,-0.137267758,-0.298275099
82,E82_,25,25,30,3,50,0.013719244,-0.803445249,-0.394863003
83,V83E,10,20,33,40,30,0.270044949,0.423487099,0.346766024
83,V83D,18,10,46,21,28,0.439627586,0.182089619,0.310858602
83,V83G,28,47,70,87,75,0.200372483,0.365734016,0.283053249
83,V83K,11,12,26,18,23,0.281080249,0.200607295,0.240843772
83,V83I,13,5,10,18,18,-0.00743319,0.302064936,0.147315873
83,V83C,12,18,18,26,30,0.017319633,0.242067006,0.12969332
83,V83H,6,10,7,16,16,-0.097431208,0.302064936,0.102316864
83,V83R,36,52,84,37,88,0.209956645,-0.067541474,0.071207585
83,V83A,24,27,35,26,51,0.070226883,0.017425356,0.04382612
83,V83T,22,24,28,25,46,0.020227866,0.044940426,0.032584146
83,V83W,15,21,18,21,36,-0.059520397,0.076285892,0.008382748
83,V83S,30,40,46,31,70,0.050767235,-0.044043435,0.0033619
83,V83_,14,11,15,11,25,0.019074361,-0.033727166,-0.007326403
83,V83L,35,44,44,25,79,-0.019949747,-0.186051703,-0.103000725
83,V83N,12,11,4,20,23,-0.451313511,0.244072989,-0.103620261
83,V83Q,17,16,21,8,33,0.04087149,-0.275171472,-0.117149991
83,V83Y,11,12,8,8,23,-0.196041006,-0.123903797,-0.159972401
83,V83F,5,11,8,2,16,-0.046278686,-0.451262731,-0.248770708
83,V83P,22,21,19,5,43,-0.112494955,-0.56323649,-0.337865723
83,V83M,19,9,12,2,28,-0.118526919,-0.683211807,-0.400869363
84,R84Y,11,20,22,28,31,0.086505584,0.259312955,0.17290927
84,R84E,10,14,20,14,24,0.154207012,0.080216186,0.117211599
84,R84M,17,17,31,18,34,0.19100966,0.036750492,0.113880076
84,R84V,42,40,52,55,82,0.035125503,0.13117487,0.083150187
84,R84K,16,9,15,17,25,0.019074361,0.142364093,0.080719227
84,R84I,9,11,13,12,20,0.053836467,0.093788993,0.07381273
84,R84H,8,18,28,8,26,0.26096196,-0.175056319,0.04295282
84,R84G,41,47,67,37,88,0.113046632,-0.067541474,0.022752579
84,R84Q,14,12,15,11,26,0.002683945,-0.050117582,-0.023716819
84,R84C,15,26,26,16,41,0.0380422,-0.090735433,-0.026346617
84,R84L,38,62,81,28,100,0.139420205,-0.23985844,-0.050219118
84,R84A,32,37,62,15,69,0.184170236,-0.338913122,-0.077371443
84,R84S,47,45,37,43,92,-0.158771626,-0.022965336,-0.090868481
84,R84N,8,16,18,5,24,0.110741318,-0.317723823,-0.103491252
84,R84D,9,16,5,19,25,-0.406894371,0.188121583,-0.109386394
84,R84F,17,37,32,15,54,0.008078977,-0.234177771,-0.113049397
84,R84T,18,20,18,11,38,-0.08238328,-0.209818425,-0.146100853
84,R84_,31,15,13,14,46,-0.296042096,-0.193941663,-0.24499188
84,R84W,17,28,10,14,45,-0.39143742,-0.184601637,-0.288019529
84,R84P,22,23,17,6,45,-0.1775576,-0.515594856,-0.346576228
85,H85M,20,14,72,27,34,0.549182542,0.205154923,0.377168732
85,H85R,45,48,101,67,93,0.265400044,0.161445995,0.21342302
85,H85V,45,58,76,99,103,0.099385112,0.285031596,0.192208354
85,H85I,9,15,13,26,24,-0.021884247,0.335488691,0.156802222
85,H85K,11,12,11,24,23,-0.071102269,0.319793703,0.124345717
85,H85_,18,10,25,15,28,0.182503076,0.04378692,0.113144998
85,H85L,61,50,131,34,111,0.301283635,-0.203085043,0.049099296
85,H85G,48,47,75,43,95,0.128470085,-0.036753621,0.045858232
85,H85W,21,24,19,28,45,-0.13180011,0.101705102,-0.015047504
85,H85F,13,23,17,16,36,-0.083001493,-0.035687867,-0.05934468
85,H85P,28,22,25,20,50,-0.062669102,-0.083285946,-0.072977524
85,H85T,16,28,13,26,44,-0.277156752,0.080216186,-0.098470283
85,H85C,18,27,20,12,45,-0.110610811,-0.246749544,-0.178680177
85,H85D,17,27,17,13,44,-0.168012282,-0.205019542,-0.186515912
85,H85A,45,27,26,23,72,-0.20203137,-0.181046683,-0.191539026
85,H85N,12,27,30,5,39,0.119229429,-0.521843805,-0.201307188
85,H85E,16,17,14,7,33,-0.125459932,-0.326323994,-0.225891963
85,H85S,51,59,32,31,110,-0.296881313,-0.238108065,-0.267494689
85,H85Q,20,22,11,9,42,-0.324359483,-0.33140352,-0.327881502
85,H85Y,27,16,8,10,43,-0.459282441,-0.299995056,-0.379638748
86,R86V,46,64,124,85,110,0.28151476,0.191240408,0.236377584
86,R86I,22,26,34,54,48,0.08379969,0.352231545,0.218015618
86,R86F,23,30,50,27,53,0.205104142,0.016829207,0.110966675
86,R86D,20,19,43,14,39,0.271320411,-0.123903797,0.073708307
86,R86M,24,21,32,25,45,0.085683834,0.054280452,0.069982143
86,R86E,18,21,19,18,39,-0.071102269,-0.021241455,-0.046171862
86,R86L,65,87,82,62,152,-0.035685612,-0.083285946,-0.059485779
86,R86G,67,74,70,52,141,-0.071102269,-0.125947539,-0.098524904
86,R86T,47,41,28,41,88,-0.257064283,-0.024075781,-0.140570032
86,R86N,24,12,15,12,36,-0.134154015,-0.152193436,-0.143173726
86,R86K,20,20,13,17,40,-0.236728095,-0.055446416,-0.146087255
86,R86W,23,32,14,17,55,-0.342169042,-0.190850586,-0.266509814
86,R86P,42,50,45,15,92,-0.075797391,-0.46229803,-0.26904771
86,R86S,65,57,32,26,122,-0.341463445,-0.356476412,-0.348969928
86,R86A,28,33,24,7,61,-0.164523955,-0.587236767,-0.375880361
86,R86Q,15,21,6,9,36,-0.493175958,-0.266136788,-0.379656373
86,R86C,41,40,29,9,81,-0.206764871,-0.611748917,-0.409256894
86,R86Y,30,31,10,12,61,-0.521071278,-0.376383401,-0.44872734
86,R86H,22,25,11,6,47,-0.372132265,-0.534078262,-0.453105263
86,R86_,23,36,10,8,59,-0.506830839,-0.521843805,-0.514337322
87,L87E,15,18,58,32,33,0.469300821,0.289099959,0.37920039
87,L87V,45,56,155,97,101,0.414452153,0.28469084,0.349571496
87,L87I,23,14,41,41,37,0.27339342,0.345530629,0.309462025
87,L87C,25,23,43,59,48,0.183184323,0.390020106,0.286602214
87,L87_,21,22,34,38,43,0.130543094,0.249676866,0.19010998
87,L87K,17,24,34,27,41,0.15074648,0.125973677,0.138360078
87,L87A,37,47,59,40,84,0.078660051,-0.014570133,0.032044959
87,L87N,10,11,11,12,21,-0.033313709,0.073585607,0.020135949
87,L87Q,11,13,11,15,24,-0.088831036,0.10824491,0.009706937
87,L87T,40,23,44,26,63,0.076960266,-0.072751274,0.002104496
87,L87R,61,59,71,40,120,0.004474852,-0.167936578,-0.081730863
87,L87S,62,58,45,63,120,-0.190099812,0.025459539,-0.082320137
87,L87D,17,18,21,9,35,0.016047906,-0.254237565,-0.119094829
87,L87P,20,39,22,17,59,-0.186495688,-0.22081381,-0.203654749
87,L87M,21,37,18,16,58,-0.262170685,-0.238338155,-0.25025442
87,L87G,61,70,46,30,131,-0.218548347,-0.327147302,-0.272847824
87,L87H,11,16,15,3,27,-0.013110323,-0.543033104,-0.278071713
87,L87F,27,20,12,5,47,-0.337370159,-0.601025051,-0.469197605
87,L87W,30,30,5,9,60,-0.777250858,-0.483264899,-0.630257879
87,L87Y,17,19,0,3,36,-1.338273998,-0.664076797,-1.001175397
88,K88L,47,59,230,262,106,0.564155928,0.692636907,0.628396417
88,K88F,17,30,81,52,47,0.462500341,0.345099568,0.403799955
88,K88C,14,19,28,46,33,0.160846807,0.442683877,0.301765342
88,K88I,21,19,66,27,40,0.443218672,0.13643911,0.289828891
88,K88T,27,24,105,23,51,0.539230248,-0.033727166,0.252751541
88,K88Q,11,19,97,8,30,0.729792108,-0.235054249,0.24736893
88,K88W,35,32,32,116,67,-0.084067247,0.537741885,0.226837319
88,K88V,36,50,64,75,86,0.10332183,0.243359275,0.173340553
88,K88_,12,28,51,20,40,0.333147213,0.011500374,0.172323793
88,K88M,21,20,55,18,41,0.354866463,-0.042430754,0.156217855
88,K88Y,16,16,22,26,32,0.073141622,0.21491476,0.144028191
88,K88R,48,60,61,95,108,-0.015107082,0.246909671,0.115901294
88,K88N,11,16,6,17,27,-0.372132265,0.110179409,-0.130976428
88,K88P,22,19,13,18,41,-0.247193529,-0.042430754,-0.144812141
88,K88D,14,19,12,10,33,-0.187607839,-0.188021296,-0.187814567
88,K88G,65,72,57,35,137,-0.146523367,-0.28151165,-0.214017508
88,K88E,18,26,8,18,44,-0.469042278,-0.072393977,-0.270718128
88,K88A,36,41,25,13,77,-0.247193529,-0.443901631,-0.34554758
88,K88H,15,15,4,8,30,-0.562463963,-0.235054249,-0.398759106
88,K88S,28,64,19,19,92,-0.437525227,-0.365388017,-0.401456622
89,I89W,30,34,42,75,64,0.050482825,0.369965171,0.210223998
89,I89_,17,31,62,19,48,0.339072196,-0.087101149,0.125985523
89,I89L,43,58,70,57,101,0.072585903,0.056892758,0.06473933
89,I89M,21,26,24,17,47,-0.053373503,-0.123903797,-0.08863865
89,I89A,34,30,35,21,64,-0.02668313,-0.16842574,-0.097554435
89,I89R,63,90,96,44,153,0.02917874,-0.232243271,-0.101532266
89,I89Y,24,19,10,30,43,-0.372132265,0.149973953,-0.111079156
89,I89P,29,31,30,15,60,-0.064040415,-0.279144917,-0.171592666
89,I89G,50,57,37,38,107,-0.223712433,-0.140294213,-0.182003323
89,I89K,15,21,11,12,36,-0.259092752,-0.152193436,-0.205643094
89,I89V,33,52,31,24,85,-0.199420747,-0.234493507,-0.216957127
89,I89C,25,30,12,19,55,-0.404316949,-0.145093096,-0.274705022
89,I89Q,23,17,26,4,40,0.048507634,-0.611748917,-0.281620642
89,I89H,21,18,9,11,39,-0.372132265,-0.22081381,-0.296473037
89,I89T,24,33,13,17,57,-0.387372232,-0.206090553,-0.296731392
89,I89N,15,17,8,8,32,-0.334343704,-0.262206495,-0.298275099
89,I89F,34,26,24,10,60,-0.1574621,-0.441872214,-0.299667157
89,I89S,62,65,50,18,127,-0.169712067,-0.526391433,-0.34805175
89,I89E,22,15,19,3,37,-0.048825875,-0.67565867,-0.362242272
89,I89D,24,23,4,2,47,-0.752343507,-0.902055047,-0.827199277
90,T90V,31,50,132,70,81,0.439965515,0.239509432,0.339737473
90,T90_,22,31,56,35,53,0.253408822,0.125973677,0.189691249
90,T90P,18,25,23,40,43,-0.033313709,0.271396116,0.119041204
90,T90R,52,50,89,51,102,0.171333011,0.005231055,0.088282033
90,T90L,48,62,63,80,110,-0.009215279,0.165226976,0.078005849
90,T90C,23,20,16,36,43,-0.183076029,0.226813983,0.021868977
90,T90F,28,23,20,35,51,-0.163856323,0.142364093,-0.010746115
90,T90E,12,18,12,16,30,-0.147490615,0.041152163,-0.053169226
90,T90Y,26,20,20,22,46,-0.119950837,-0.008305086,-0.064127962
90,T90H,10,13,3,29,23,-0.548223524,0.398974949,-0.074624288
90,T90I,23,24,17,20,47,-0.196041006,-0.056957007,-0.126499007
90,T90M,15,17,9,13,32,-0.288586214,-0.070320968,-0.179453591
90,T90D,21,20,7,23,41,-0.490231577,0.059026887,-0.215602345
90,T90G,38,55,27,29,93,-0.296042096,-0.193941663,-0.24499188
90,T90N,10,25,22,4,35,0.035353061,-0.555267561,-0.25995725
90,T90A,29,34,15,19,63,-0.372132265,-0.203085043,-0.287608654
90,T90W,19,28,16,9,47,-0.22086459,-0.379176302,-0.300020446
90,T90K,16,20,11,7,36,-0.259092752,-0.363046801,-0.311069777
90,T90Q,20,13,7,9,33,-0.398461204,-0.229413981,-0.313937593
90,T90S,44,54,17,27,98,-0.510434963,-0.246412228,-0.378423595
91,E91M,20,10,24,8,30,0.136506041,-0.235054249,-0.049274104
91,E91W,22,19,15,19,41,-0.189201582,-0.020154359,-0.10467797
91,E91Q,6,13,7,8,19,-0.168012282,-0.044722551,-0.106367417
91,E91F,18,15,21,7,33,0.04087149,-0.326323994,-0.142726252
91,E91K,17,9,13,6,26,-0.055308002,-0.284200788,-0.169754395
91,E91_,13,22,12,12,35,-0.212431422,-0.140294213,-0.176362818
91,E91A,30,25,17,19,55,-0.262987796,-0.145093096,-0.204040446
91,E91Y,11,11,7,5,22,-0.228710123,-0.28151165,-0.255110886
91,E91V,45,46,29,22,91,-0.256738846,-0.299995056,-0.278366951
91,E91L,37,41,16,27,78,-0.437250444,-0.148404124,-0.292827284
91,E91R,41,49,28,19,90,-0.266715668,-0.355946461,-0.311331065
91,E91D,18,14,9,6,32,-0.288586214,-0.371350964,-0.329968589
91,E91I,17,16,16,3,33,-0.071102269,-0.62735399,-0.34922813
91,E91S,50,50,36,13,100,-0.206191924,-0.556128402,-0.381160163
91,E91P,22,28,21,5,50,-0.135219769,-0.62735399,-0.38128688
91,E91C,20,25,7,12,45,-0.529740119,-0.246749544,-0.388244831
91,E91H,13,11,11,1,24,-0.088831036,-0.794845077,-0.441838057
91,E91G,56,39,11,21,95,-0.673162261,-0.337783617,-0.505472939
91,E91T,18,26,3,11,44,-0.821224796,-0.271966332,-0.546595564
91,E91N,10,14,1,1,24,-0.866982287,-0.794845077,-0.830913682
92,N92_,10,21,23,27,31,0.10498899,0.244072989,0.174530989
92,N92W,16,23,33,25,39,0.159346652,0.114978292,0.137162472
92,N92H,9,8,16,8,17,0.205104142,0.00103494,0.103069541
92,N92K,9,11,14,11,20,0.08379969,0.059026887,0.071413289
92,N92P,15,15,15,22,30,-0.057313985,0.172431078,0.057558546
92,N92E,11,14,24,9,25,0.212894387,-0.112908412,0.049992987
92,N92S,43,47,39,63,90,-0.127053675,0.149203517,0.011074921
92,N92L,57,55,56,64,112,-0.067275862,0.061899849,-0.002688006
92,N92A,24,27,18,39,51,-0.207322017,0.188121583,-0.009600217
92,N92R,42,36,35,42,78,-0.111396864,0.0379063,-0.036745282
92,N92I,9,11,21,3,20,0.250131112,-0.418094368,-0.083981628
92,N92D,15,18,24,7,33,0.096388818,-0.326323994,-0.114967588
92,N92M,15,16,14,10,31,-0.099130993,-0.161692357,-0.130411675
92,N92F,16,14,22,5,30,0.100293868,-0.411145508,-0.15542582
92,N92Q,13,11,6,11,24,-0.322914242,-0.016693827,-0.169804035
92,N92C,23,22,18,12,45,-0.154076505,-0.246749544,-0.200413024
92,N92G,42,32,23,25,74,-0.264922296,-0.15802298,-0.211472638
92,N92T,22,25,14,15,47,-0.275222252,-0.175056319,-0.225139286
92,N92Y,16,19,11,9,35,-0.247193529,-0.254237565,-0.250715547
92,N92V,49,46,31,19,95,-0.247193529,-0.379176302,-0.313184915
93,S93_,14,16,13,46,30,-0.115305932,0.4828011,0.183747584
93,S93E,21,15,13,13,36,-0.192145962,-0.120008753,-0.156077357
93,S93P,14,32,8,33,46,-0.487927622,0.161445995,-0.163240814
93,S93Q,12,14,19,3,26,0.099593958,-0.527238837,-0.21382244
93,S93G,39,55,26,28,94,-0.316432115,-0.213260672,-0.264846393
93,S93K,15,15,8,4,30,-0.307191458,-0.490326754,-0.398759106
93,S93W,20,27,11,6,47,-0.372132265,-0.534078262,-0.453105263
93,S93D,16,23,6,5,39,-0.527034225,-0.521843805,-0.524439015
93,S93R,50,63,20,9,113,-0.50475783,-0.754839916,-0.629798873
93,S93F,17,21,4,2,38,-0.662166877,-0.811878417,-0.737022647
93,S93N,13,27,2,4,40,-0.905734876,-0.611748917,-0.758741896
93,S93Y,17,12,3,1,29,-0.645133537,-0.874026323,-0.75957993
93,S93T,25,25,3,4,50,-0.875582459,-0.706535236,-0.791058847
93,S93L,57,59,9,9,116,-0.838258136,-0.766120926,-0.802189531
93,S93M,12,17,0,2,29,-1.247193529,-0.697935064,-0.972564296
93,S93I,21,22,1,2,43,-1.112494955,-0.864266486,-0.98838072
93,S93A,35,54,3,5,89,-1.122254792,-0.874026323,-0.998140558
93,S93H,9,16,0,1,25,-1.185045622,-0.811878417,-0.998462019
93,S93V,40,46,4,3,86,-1.010621522,-1.035394326,-1.023007924
93,S93C,17,19,0,0,36,-1.338273998,-1.266136788,-1.302205393
94,F94C,27,33,110,79,60,0.48992087,0.419825088,0.454872979
94,F94A,42,43,160,101,85,0.502255151,0.376166656,0.439210904
94,F94G,73,81,165,150,154,0.259704116,0.290710185,0.27520715
94,F94M,28,35,48,83,63,0.113943832,0.420164248,0.26705404
94,F94T,38,42,122,48,80,0.411347819,0.083775997,0.247561908
94,F94S,82,78,120,124,160,0.10588722,0.192149073,0.149018147
94,F94V,69,64,96,107,133,0.089594662,0.208383893,0.148989277
94,F94_,27,26,41,34,53,0.120783257,0.11373922,0.117261238
94,F94W,19,40,52,25,59,0.176052345,-0.061112967,0.057469689
94,F94L,63,76,60,92,139,-0.130870474,0.124419849,-0.003225313
94,F94E,20,28,25,20,48,-0.045295006,-0.06591185,-0.055603428
94,F94P,27,46,58,18,73,0.131548018,-0.288413183,-0.078432582
94,F94Y,21,26,20,17,47,-0.129094216,-0.123903797,-0.126499007
94,F94Q,21,24,36,5,45,0.135371619,-0.582541646,-0.223585014
94,F94I,22,31,15,18,53,-0.298346051,-0.151575223,-0.224960637
94,F94D,22,25,12,17,47,-0.337370159,-0.123903797,-0.230636978
94,F94K,31,23,14,12,54,-0.334343704,-0.324354401,-0.329349053
94,F94R,76,78,34,32,154,-0.416335928,-0.369752823,-0.393044375
94,F94N,18,18,7,5,36,-0.435184011,-0.487985538,-0.461584774
94,F94H,18,15,5,4,33,-0.52339994,-0.530443977,-0.526921959
95,E95V,45,62,137,103,107,0.336383057,0.28567452,0.311028788
95,E95T,16,24,34,55,40,0.161211914,0.437469106,0.29934051
95,E95W,22,23,24,30,45,-0.034890097,0.130668798,0.047889351
95,E95D,19,18,27,14,37,0.097302161,-0.101627402,-0.00216262
95,E95N,8,12,15,7,20,0.111828414,-0.117064372,-0.002617979
95,E95I,11,13,11,13,24,-0.088831036,0.050252963,-0.019289037
95,E95H,14,7,6,16,21,-0.267396915,0.190091176,-0.038652869
95,E95M,15,23,18,16,38,-0.08238328,-0.05855075,-0.070467015
95,E95A,29,26,18,32,55,-0.2395067,0.072390849,-0.083557926
95,E95P,24,26,24,19,50,-0.079702441,-0.104475245,-0.092088843
95,E95S,46,43,54,25,89,0.016047906,-0.237204226,-0.11057816
95,E95L,45,68,40,53,113,-0.214193268,-0.022446156,-0.118319712
95,E95F,18,19,25,7,37,0.065117478,-0.374628674,-0.154755598
95,E95G,52,40,39,25,92,-0.136495231,-0.251444665,-0.193969948
95,E95R,54,66,38,40,120,-0.261793037,-0.167936578,-0.214864808
95,E95Y,9,13,6,7,22,-0.28670207,-0.156572913,-0.221637492
95,E95Q,21,18,22,6,39,-0.010404429,-0.454897016,-0.232650722
95,E95C,12,21,10,8,33,-0.260158506,-0.275171472,-0.267664989
95,E95K,21,10,8,8,31,-0.320979743,-0.248842533,-0.284911138
95,E95_,15,23,8,9,38,-0.406894371,-0.288999671,-0.347947021
96,Q96K,11,18,13,46,29,-0.101065493,0.497041539,0.197988023
96,Q96R,56,68,63,41,124,-0.060802313,-0.171595787,-0.11619905
96,Q96S,53,64,47,47,117,-0.160713044,-0.088575834,-0.124644439
96,Q96N,15,17,10,15,32,-0.247193529,-0.012329022,-0.129761275
96,Q96_,15,24,16,13,39,-0.141683344,-0.15386702,-0.147775182
96,Q96P,24,27,15,21,51,-0.281955635,-0.071515727,-0.176735681
96,Q96G,66,70,44,21,136,-0.253580327,-0.492232951,-0.372906639
96,Q96H,14,13,8,3,27,-0.262987796,-0.543033104,-0.40301045
96,Q96I,12,21,7,4,33,-0.398461204,-0.530443977,-0.46445259
96,Q96D,18,30,4,15,48,-0.76129835,-0.184011162,-0.472654756
96,Q96Y,10,19,7,2,29,-0.344103542,-0.697935064,-0.521019303
96,Q96V,47,50,17,13,97,-0.506025844,-0.543033104,-0.524529474
96,Q96E,15,22,5,4,37,-0.57170462,-0.578748657,-0.575226638
96,Q96M,23,26,6,6,49,-0.623944238,-0.551807029,-0.587875633
96,Q96T,25,33,8,6,58,-0.586681776,-0.623689036,-0.605185406
96,Q96L,72,67,13,19,139,-0.770072274,-0.543033104,-0.656552689
96,Q96W,35,31,3,10,66,-0.994087085,-0.482617182,-0.738352134
96,Q96A,37,41,9,5,78,-0.667699365,-0.817410905,-0.742555135
96,Q96F,33,35,3,4,68,-1.006861373,-0.837814151,-0.922337762
96,Q96C,27,31,1,3,58,-1.23989429,-0.866727085,-1.053310687
97,I97L,36,36,210,107,72,0.690887321,0.472165831,0.581526576
97,I97M,11,11,17,6,22,0.123472395,-0.21456486,-0.045546233
97,I97_,13,26,18,10,39,-0.093378664,-0.25860237,-0.175990517
97,I97T,20,21,10,7,41,-0.351928879,-0.418094368,-0.385011623
97,I97Q,10,14,11,1,24,-0.088831036,-0.794845077,-0.441838057
97,I97F,18,22,9,5,40,-0.382856131,-0.532567671,-0.457711901
97,I97P,18,13,5,5,31,-0.497071002,-0.424933792,-0.461002397
97,I97N,10,10,1,5,20,-0.791261573,-0.242003109,-0.516632341
97,I97H,9,16,5,2,25,-0.406894371,-0.635787158,-0.521340764
97,I97C,15,23,7,4,38,-0.458046894,-0.590029667,-0.52403828
97,I97K,12,12,3,2,24,-0.565952291,-0.618753818,-0.592353055
97,I97E,10,13,2,2,23,-0.673162261,-0.601025051,-0.637093656
97,I97D,15,15,4,2,30,-0.562463963,-0.712175503,-0.637319733
97,I97S,38,46,14,5,84,-0.52339994,-0.84920274,-0.68630134
97,I97V,38,40,7,6,78,-0.764609378,-0.750464116,-0.757536747
97,I97R,46,59,9,5,105,-0.795378139,-0.945089679,-0.870233909
97,I97G,45,56,2,14,101,-1.301551191,-0.530443977,-0.915997584
97,I97W,21,34,2,2,55,-1.041139046,-0.969001837,-1.005070441
97,I97Y,24,17,4,0,41,-0.69435156,-1.321184355,-1.007767957
97,I97A,25,28,4,0,53,-0.803496029,-1.430328824,-1.116912427
98,T98S,40,44,40,67,84,-0.086707343,0.205154923,0.05922379
98,T98_,17,23,26,18,40,0.048507634,-0.03196532,0.008271157
98,T98Y,14,8,6,19,22,-0.28670207,0.241367095,-0.022667487
98,T98K,21,20,21,18,41,-0.050898883,-0.042430754,-0.046664819
98,T98P,15,25,24,14,40,0.015083878,-0.134627662,-0.059771892
98,T98N,14,18,15,11,32,-0.084466231,-0.137267758,-0.110866995
98,T98L,51,58,45,42,109,-0.148707127,-0.105859294,-0.127283211
98,T98F,20,26,16,13,46,-0.21172121,-0.223904887,-0.217813048
98,T98M,17,21,6,21,38,-0.516038841,0.05342301,-0.231307916
98,T98G,54,50,25,34,104,-0.376288225,-0.175056319,-0.275672272
98,T98H,10,11,3,8,21,-0.510434963,-0.086115236,-0.298275099
98,T98C,18,25,12,5,43,-0.299581598,-0.56323649,-0.431409044
98,T98E,15,18,4,7,33,-0.602581187,-0.326323994,-0.46445259
98,T98V,35,36,9,14,71,-0.62740477,-0.379176302,-0.503290536
98,T98Q,14,20,6,4,34,-0.469042278,-0.543033104,-0.506037691
98,T98I,16,28,1,26,44,-1.122254792,0.080216186,-0.521019303
98,T98A,25,38,16,4,63,-0.345803326,-0.805145034,-0.57547418
98,T98W,23,20,4,6,43,-0.714554946,-0.496289701,-0.605422323
98,T98R,57,61,9,20,118,-0.845619235,-0.451262731,-0.648440983
98,T98D,16,22,4,0,38,-0.662166877,-1.288999671,-0.975583274
99,F99L,44,40,88,865,84,0.249898807,1.310163902,0.780031355
99,F99I,17,17,27,13,34,0.133017713,-0.095875073,0.01857132
99,F99T,27,30,18,37,57,-0.254746666,0.118420539,-0.068163064
99,F99P,25,24,18,24,49,-0.190288677,0.00103494,-0.094626869
99,F99V,57,40,56,29,97,-0.005423494,-0.212039885,-0.10873169
99,F99S,47,54,26,21,101,-0.347308681,-0.364112555,-0.355710618
99,F99C,16,28,9,6,44,-0.423284788,-0.506049538,-0.464667163
99,F99M,16,19,4,6,35,-0.62740477,-0.409139525,-0.518272148
99,F99N,16,19,3,4,35,-0.724314783,-0.555267561,-0.639791172
99,F99H,9,15,2,2,24,-0.690891028,-0.618753818,-0.654822423
99,F99K,14,21,5,2,35,-0.548223524,-0.77711631,-0.662669917
99,F99Y,11,14,3,1,25,-0.58298563,-0.811878417,-0.697432024
99,F99Q,16,17,4,0,33,-0.602581187,-1.229413981,-0.915997584
99,F99R,65,55,8,6,120,-0.898615135,-0.935622395,-0.917118765
99,F99A,36,40,1,8,76,-1.355533003,-0.63018328,-0.992858142
99,F99E,17,18,0,2,35,-1.326374775,-0.77711631,-1.051745542
99,F99W,21,24,1,1,45,-1.13180011,-1.0596629,-1.095731505
99,F99D,21,19,0,1,40,-1.382856131,-1.009688925,-1.196272528
99,F99_,23,17,0,1,40,-1.382856131,-1.009688925,-1.196272528
99,F99G,66,72,3,3,138,-1.311027083,-1.238889873,-1.274958478
100,M100N,15,17,50,88,32,0.418983962,0.732941002,0.575962482
100,M100D,18,17,72,72,35,0.536948086,0.609085295,0.57301669
100,M100E,20,25,56,47,45,0.32304475,0.320548341,0.321796546
100,M100S,40,56,94,103,96,0.220879597,0.332326541,0.276603069
100,M100G,38,54,80,51,92,0.169929796,0.049585331,0.109757564
100,M100K,16,23,18,19,39,-0.093378664,0.00103494,-0.046171862
100,M100A,14,22,19,9,36,-0.037244002,-0.266136788,-0.151690395
100,M100R,52,62,55,32,114,-0.082582087,-0.240118965,-0.161350526
100,M100I,20,20,9,19,40,-0.382856131,-0.009688925,-0.196272528
100,M100T,18,36,19,7,54,-0.209404968,-0.535207767,-0.372306367
100,M100V,41,51,18,22,92,-0.459801621,-0.304690177,-0.382245899
100,M100Q,18,14,7,2,32,-0.385496227,-0.739327749,-0.562411988
100,M100W,30,32,6,8,62,-0.724314783,-0.543033104,-0.633673944
100,M100L,40,50,11,2,90,-0.64993242,-1.179855202,-0.914893811
100,M100P,24,13,2,1,37,-0.872734616,-0.976688665,-0.92471164
100,M100Y,14,20,4,0,34,-0.615170314,-1.242003109,-0.928586711
100,M100C,19,33,1,3,52,-1.193318148,-0.820150943,-1.006734545
100,M100F,14,15,0,1,29,-1.247193529,-0.874026323,-1.060609926
100,M100_,29,27,1,1,56,-1.224917134,-1.152779924,-1.188848529
100,M100H,17,20,0,0,37,-1.34985587,-1.277718661,-1.313787266
101,Q101I,27,19,2,2,46,-0.965048877,-0.892911668,-0.928980272
101,Q101F,17,19,0,1,36,-1.338273998,-0.965106793,-1.151690395
101,Q101H,20,19,1,0,39,-1.071102269,-1.299995056,-1.185548663
101,Q101E,19,22,1,0,41,-1.092291569,-1.321184355,-1.206737962
101,Q101_,29,30,1,1,59,-1.247193529,-1.175056319,-1.211124924
101,Q101P,34,43,2,1,77,-1.185045622,-1.288999671,-1.237022647
101,Q101K,26,29,0,2,55,-1.518260301,-0.969001837,-1.243631069
101,Q101D,17,15,0,0,32,-1.288586214,-1.216449004,-1.252517609
101,Q101Y,21,25,0,1,46,-1.442170132,-1.069002927,-1.255586529
101,Q101N,20,15,0,0,35,-1.326374775,-1.254237565,-1.29030617
101,Q101R,81,79,2,4,160,-1.499776895,-1.205790936,-1.352783916
101,Q101W,30,43,0,1,73,-1.639303994,-1.266136788,-1.452720391
101,Q101T,39,54,2,0,93,-1.266078873,-1.671062918,-1.468570895
101,Q101S,71,69,5,0,140,-1.141140136,-1.847154177,-1.494147157
101,Q101M,24,34,0,0,58,-1.540924285,-1.468787076,-1.504855681
101,Q101C,30,29,0,0,59,-1.548223524,-1.476086315,-1.512154919
101,Q101L,69,82,1,1,151,-1.650885866,-1.578748657,-1.614817261
101,Q101A,46,45,0,0,91,-1.733860101,-1.661722892,-1.697791496
101,Q101V,58,46,0,0,104,-1.791261573,-1.719124363,-1.755192968
101,Q101G,56,73,0,0,129,-1.884015626,-1.811878417,-1.847947021
102,A102V,67,67,6,6,134,-1.055308002,-0.983170793,-1.019239398
102,A102_,17,11,0,1,28,-1.232470272,-0.859303067,-1.045886669
102,A102Y,17,16,1,0,33,-1.000521195,-1.229413981,-1.114967588
102,A102M,21,21,1,0,42,-1.102510734,-1.33140352,-1.216957127
102,A102K,19,14,0,0,33,-1.301551191,-1.229413981,-1.265482586
102,A102I,13,20,0,0,33,-1.301551191,-1.229413981,-1.265482586
102,A102D,25,37,0,2,62,-1.569412823,-1.020154359,-1.294783591
102,A102H,27,24,1,0,51,-1.185045622,-1.413938408,-1.299492015
102,A102Q,37,23,0,1,60,-1.555402109,-1.182234904,-1.368818506
102,A102S,64,77,2,2,141,-1.445239363,-1.373102154,-1.409170759
102,A102N,21,26,0,0,47,-1.451313511,-1.379176302,-1.415244906
102,A102F,28,20,0,0,48,-1.460268354,-1.388131144,-1.424199749
102,A102E,26,28,0,0,54,-1.510434963,-1.438297754,-1.474366359
102,A102T,36,43,1,0,79,-1.372132265,-1.601025051,-1.486578658
102,A102C,31,29,0,0,60,-1.555402109,-1.483264899,-1.519333504
102,A102W,35,39,0,0,74,-1.645133537,-1.572996328,-1.609064932
102,A102L,72,76,2,0,148,-1.466137288,-1.871121333,-1.66862931
102,A102P,44,43,0,0,87,-1.714554946,-1.642417736,-1.678486341
102,A102G,70,88,1,0,158,-1.670439402,-1.899332189,-1.784885796
102,A102R,80,102,0,0,182,-2.032523364,-1.960386154,-1.996454759
103,L103M,18,24,28,12,42,0.058857268,-0.217460168,-0.07930145
103,L103F,18,22,26,7,40,0.048507634,-0.407628934,-0.17956065
103,L103K,4,6,1,6,10,-0.510434963,0.105770291,-0.202332336
103,L103V,45,58,22,34,103,-0.425377777,-0.170900359,-0.298139068
103,L103I,15,13,4,5,28,-0.533500267,-0.382181812,-0.45784104
103,L103W,31,33,14,7,64,-0.406894371,-0.607758434,-0.507326403
103,L103S,28,69,8,9,97,-0.80705584,-0.68916114,-0.74810849
103,L103Y,19,18,2,2,37,-0.872734616,-0.800597406,-0.836666011
103,L103D,16,21,7,0,37,-0.446765883,-1.277718661,-0.862242272
103,L103N,16,16,2,1,32,-0.811464959,-0.915419009,-0.863441984
103,L103_,17,15,2,1,32,-0.811464959,-0.915419009,-0.863441984
103,L103E,17,30,1,4,47,-1.150283516,-0.680206297,-0.915244906
103,L103T,12,22,0,4,34,-1.314140318,-0.543033104,-0.928586711
103,L103C,19,27,6,0,46,-0.597072092,-1.370032922,-0.983552507
103,L103H,13,12,1,0,25,-0.884015626,-1.112908412,-0.998462019
103,L103R,60,80,4,9,140,-1.220321382,-0.847154177,-1.03373778
103,L103P,17,21,0,2,38,-1.361136881,-0.811878417,-1.086507649
103,L103G,72,64,3,6,136,-1.30473285,-0.989557591,-1.147145221
103,L103Q,22,16,1,0,38,-1.060106885,-1.288999671,-1.174553278
103,L103A,36,53,2,0,89,-1.247193529,-1.652177574,-1.449685551
104,Q104Y,14,11,54,12,25,0.555317068,0.00103494,0.278176004
104,Q104D,12,13,11,23,25,-0.105864376,0.267302829,0.080719227
104,Q104H,17,21,27,18,38,0.08602115,-0.01024607,0.03788754
104,Q104F,10,30,18,11,40,-0.10410253,-0.231537675,-0.167820102
104,Q104N,18,17,17,7,35,-0.071102269,-0.351147578,-0.211124924
104,Q104C,19,27,5,33,46,-0.664018881,0.161445995,-0.251286443
104,Q104G,41,39,18,30,80,-0.399803692,-0.115058389,-0.257431041
104,Q104K,3,0,0,0,3,-0.372132265,-0.299995056,-0.33606366
104,Q104A,39,34,15,9,73,-0.435184011,-0.567166784,-0.501175397
104,Q104V,32,44,27,5,76,-0.209404968,-0.806274539,-0.507839753
104,Q104I,13,15,6,2,28,-0.387372232,-0.683211807,-0.53529202
104,Q104T,27,33,11,6,60,-0.476220863,-0.638166859,-0.557193861
104,Q104S,49,50,22,7,99,-0.408344438,-0.794845077,-0.601594758
104,Q104P,28,32,8,4,60,-0.601159599,-0.784294895,-0.692727247
104,Q104L,48,47,10,6,95,-0.710950822,-0.835108257,-0.77302954
104,Q104E,18,23,2,2,41,-0.91620031,-0.8440631,-0.880131705
104,Q104R,60,60,7,6,120,-0.949767657,-0.935622395,-0.942695026
104,Q104M,23,18,2,1,41,-0.91620031,-1.020154359,-0.968177334
104,Q104_,21,27,3,1,48,-0.858208363,-1.087101149,-0.972654756
104,Q104W,28,20,0,1,48,-1.460268354,-1.087101149,-1.273684751
105,L105H,15,23,8,3,38,-0.406894371,-0.68693968,-0.546917026
105,L105_,13,23,1,2,36,-1.037244002,-0.789015534,-0.913129768
105,L105I,14,24,2,1,38,-0.884015626,-0.987969676,-0.935992651
105,L105A,11,11,0,1,22,-1.13180011,-0.758632905,-0.945216507
105,L105P,29,45,4,3,74,-0.946163533,-0.970936336,-0.958549935
105,L105R,53,51,6,4,104,-0.946163533,-1.020154359,-0.983158946
105,L105N,26,17,2,1,43,-0.936403696,-1.040357745,-0.98838072
105,L105S,46,56,5,4,102,-1.004758248,-1.011802285,-1.008280266
105,L105M,22,16,2,0,38,-0.884015626,-1.288999671,-1.086507649
105,L105E,13,20,1,0,33,-1.000521195,-1.229413981,-1.114967588
105,L105K,15,19,0,1,34,-1.314140318,-0.940973113,-1.127556716
105,L105C,17,19,1,0,36,-1.037244002,-1.266136788,-1.151690395
105,L105D,23,16,1,0,39,-1.071102269,-1.299995056,-1.185548663
105,L105Q,20,19,0,1,39,-1.372132265,-0.99896506,-1.185548663
105,L105Y,18,26,0,1,44,-1.423284788,-1.050117582,-1.236701185
105,L105F,18,21,0,0,39,-1.372132265,-1.299995056,-1.33606366
105,L105G,20,19,0,0,39,-1.372132265,-1.299995056,-1.33606366
105,L105W,16,24,0,0,40,-1.382856131,-1.310718921,-1.346787526
105,L105V,44,36,1,0,80,-1.377527297,-1.606420083,-1.49197369
105,L105T,24,38,0,0,62,-1.569412823,-1.497275614,-1.533344219
106,L106A,37,29,65,81,66,0.223396859,0.389803985,0.306600422
106,L106M,13,17,21,17,30,0.080988713,0.065975747,0.07348223
106,L106V,39,56,69,27,95,0.092754533,-0.233048266,-0.070146866
106,L106E,16,20,17,12,36,-0.083001493,-0.152193436,-0.117597464
106,L106G,34,49,26,33,83,-0.262987796,-0.090735433,-0.176861615
106,L106W,16,21,19,5,37,-0.048825875,-0.499567411,-0.274196643
106,L106Q,16,20,10,6,36,-0.296881313,-0.421038748,-0.358960031
106,L106_,23,30,13,10,53,-0.356337998,-0.388936139,-0.372637068
106,L106P,30,32,5,15,62,-0.791261573,-0.293155631,-0.542208602
106,L106S,40,48,9,16,88,-0.71946228,-0.41687615,-0.568169215
106,L106T,20,36,4,5,56,-0.826977125,-0.67565867,-0.751317897
106,L106R,24,38,7,3,62,-0.666322836,-0.895215622,-0.780769229
106,L106K,18,17,1,3,35,-1.025344779,-0.652177574,-0.838761176
106,L106F,20,19,3,0,39,-0.770072274,-1.299995056,-1.035033665
106,L106I,15,17,0,1,32,-1.288586214,-0.915419009,-1.102002611
106,L106Y,24,18,0,2,42,-1.403540729,-0.854282265,-1.128911497
106,L106H,12,16,0,0,28,-1.232470272,-1.160333062,-1.196401667
106,L106C,15,30,1,0,45,-1.13180011,-1.360692896,-1.246246503
106,L106N,19,17,0,0,36,-1.338273998,-1.266136788,-1.302205393
106,L106D,20,30,0,0,50,-1.47764245,-1.40550524,-1.441573845
107,L107A,41,29,5,4,70,-0.843179372,-0.850223409,-0.84670139
107,L107Y,20,22,2,1,42,-0.926419475,-1.030373524,-0.978396499
107,L107P,29,23,2,2,52,-1.017226889,-0.945089679,-0.981158284
107,L107H,12,10,0,0,22,-1.13180011,-1.0596629,-1.095731505
107,L107_,12,15,0,0,27,-1.217230305,-1.145093096,-1.1811617
107,L107I,13,17,0,0,30,-1.261433968,-1.189296758,-1.225365363
107,L107N,12,19,0,0,31,-1.275222252,-1.203085043,-1.239153647
107,L107K,13,21,0,0,34,-1.314140318,-1.242003109,-1.278071713
107,L107V,41,54,1,2,95,-1.451313511,-1.203085043,-1.327199277
107,L107M,25,32,1,0,57,-1.232470272,-1.461363058,-1.346916665
107,L107D,18,24,0,0,42,-1.403540729,-1.33140352,-1.367472125
107,L107W,12,30,0,0,42,-1.403540729,-1.33140352,-1.367472125
107,L107Q,17,25,0,0,42,-1.403540729,-1.33140352,-1.367472125
107,L107E,22,21,0,0,43,-1.41352495,-1.341387741,-1.377456346
107,L107F,23,22,0,0,45,-1.432830106,-1.360692896,-1.396761501
107,L107C,22,28,0,0,50,-1.47764245,-1.40550524,-1.441573845
107,L107S,38,53,0,2,91,-1.733860101,-1.184601637,-1.459230869
107,L107T,36,32,0,0,68,-1.608921365,-1.536784155,-1.57285276
107,L107G,60,58,1,0,118,-1.54458924,-1.773482026,-1.659035633
107,L107R,51,81,0,0,132,-1.893923915,-1.821786705,-1.85785531
108,E108K,15,20,2,1,35,-0.84925352,-0.953207569,-0.901230545
108,E108N,11,12,1,0,23,-0.84925352,-1.078146306,-0.963699913
108,E108M,20,14,3,0,34,-0.712080327,-1.242003109,-0.977041718
108,E108I,16,15,2,0,31,-0.798100997,-1.203085043,-1.00059302
108,E108C,15,24,0,2,39,-1.372132265,-0.822873801,-1.097503033
108,E108Y,16,16,1,0,32,-0.987556218,-1.216449004,-1.102002611
108,E108W,22,15,1,0,37,-1.048825875,-1.277718661,-1.163272268
108,E108T,29,26,3,0,55,-0.91620031,-1.446123091,-1.1811617
108,E108Q,10,18,0,0,28,-1.232470272,-1.160333062,-1.196401667
108,E108H,15,14,0,0,29,-1.247193529,-1.175056319,-1.211124924
108,E108G,30,60,2,2,90,-1.251992411,-1.179855202,-1.215923807
108,E108V,41,35,2,1,76,-1.179441744,-1.283395794,-1.231418769
108,E108R,39,49,3,1,88,-1.117402289,-1.346295075,-1.231848682
108,E108D,29,18,0,1,47,-1.451313511,-1.078146306,-1.264729909
108,E108P,14,20,0,0,34,-1.314140318,-1.242003109,-1.278071713
108,E108_,16,21,0,0,37,-1.34985587,-1.277718661,-1.313787266
108,E108A,21,34,0,1,55,-1.518260301,-1.145093096,-1.331676698
108,E108F,16,23,0,0,39,-1.372132265,-1.299995056,-1.33606366
108,E108S,54,53,2,1,107,-1.326374775,-1.430328824,-1.378351799
108,E108L,41,50,3,0,91,-1.13180011,-1.661722892,-1.396761501
109,V109G,44,49,22,22,93,-0.381472291,-0.309335082,-0.345403687
109,V109_,15,17,3,3,32,-0.686526222,-0.614389013,-0.650457618
109,V109Y,13,13,1,3,26,-0.900406042,-0.527238837,-0.71382244
109,V109C,23,27,6,3,50,-0.63254441,-0.803445249,-0.717994829
109,V109M,17,16,2,3,33,-0.824429936,-0.62735399,-0.725891963
109,V109N,9,11,3,0,20,-0.490231577,-1.020154359,-0.755192968
109,V109R,56,63,8,9,119,-0.89501101,-0.77711631,-0.83606366
109,V109A,32,37,6,3,69,-0.770072274,-0.940973113,-0.855522693
109,V109E,17,25,2,2,42,-0.926419475,-0.854282265,-0.89035087
109,V109L,67,65,8,7,132,-0.939681405,-0.918696718,-0.929189062
109,V109H,15,16,0,1,31,-1.275222252,-0.902055047,-1.08863865
109,V109I,17,16,0,1,33,-1.301551191,-0.928383986,-1.114967588
109,V109P,36,25,1,2,61,-1.261433968,-1.013205499,-1.137319733
109,V109F,29,26,0,3,55,-1.518260301,-0.8440631,-1.1811617
109,V109K,19,21,0,1,40,-1.382856131,-1.009688925,-1.196272528
109,V109Q,18,17,0,0,35,-1.326374775,-1.254237565,-1.29030617
109,V109S,52,63,4,1,115,-1.135560259,-1.461363058,-1.298461658
109,V109T,31,28,1,0,59,-1.247193529,-1.476086315,-1.361639922
109,V109D,20,22,0,0,42,-1.403540729,-1.33140352,-1.367472125
109,V109W,26,33,0,0,59,-1.548223524,-1.476086315,-1.512154919
110,E110D,34,40,41,46,74,-0.021884247,0.09910153,0.038608642
110,E110G,70,100,102,80,170,0.00976884,-0.022446156,-0.006338658
110,E110_,27,30,73,9,57,0.335731452,-0.461363058,-0.062815803
110,E110W,24,45,41,21,69,0.008078977,-0.200610423,-0.096265723
110,E110A,61,59,42,49,120,-0.219389189,-0.08175043,-0.150569809
110,E110V,80,86,59,63,166,-0.214637495,-0.114471561,-0.164554528
110,E110P,42,39,13,17,81,-0.537758091,-0.356476412,-0.447117251
110,E110N,11,17,4,4,28,-0.533500267,-0.461363058,-0.497431663
110,E110M,21,32,8,8,53,-0.548223524,-0.476086315,-0.512154919
110,E110F,22,32,9,6,54,-0.510434963,-0.593199714,-0.551817339
110,E110I,22,21,3,10,43,-0.811464959,-0.299995056,-0.555730007
110,E110T,39,38,11,9,77,-0.58298563,-0.590029667,-0.586507649
110,E110H,13,19,4,2,32,-0.589616209,-0.739327749,-0.664471979
110,E110Y,34,28,3,8,62,-0.967352832,-0.543033104,-0.755192968
110,E110S,71,76,6,27,147,-1.095235949,-0.421038748,-0.758137349
110,E110C,38,32,7,4,70,-0.718240636,-0.850223409,-0.784232022
110,E110K,29,28,5,2,57,-0.755349017,-0.984241803,-0.86979541
110,E110R,81,110,11,13,191,-0.974192256,-0.835108257,-0.904650257
110,E110L,77,97,7,13,174,-1.110020336,-0.794845077,-0.952432706
110,E110Q,24,19,1,0,43,-1.112494955,-1.341387741,-1.226941348
111,Q111H,17,13,2,4,30,-0.784312713,-0.490326754,-0.637319733
111,Q111S,44,59,6,23,103,-0.942007573,-0.334757162,-0.638382367
111,Q111E,25,26,3,8,51,-0.884015626,-0.459695898,-0.671855762
111,Q111M,21,20,4,3,41,-0.69435156,-0.719124363,-0.706737962
111,Q111K,28,26,5,4,54,-0.732283713,-0.739327749,-0.735805731
111,Q111_,19,19,2,4,38,-0.884015626,-0.590029667,-0.737022647
111,Q111C,26,20,4,3,46,-0.743200127,-0.767972931,-0.755586529
111,Q111N,17,22,3,2,39,-0.770072274,-0.822873801,-0.796473037
111,Q111Y,24,11,2,2,35,-0.84925352,-0.77711631,-0.813184915
111,Q111D,14,13,2,0,27,-0.74010905,-1.145093096,-0.942601073
111,Q111W,21,21,1,2,42,-1.102510734,-0.854282265,-0.978396499
111,Q111R,74,73,6,9,147,-1.095235949,-0.86819678,-0.981716364
111,Q111T,32,29,3,1,61,-0.960403972,-1.189296758,-1.074850365
111,Q111I,10,16,0,0,26,-1.201436038,-1.129298828,-1.165367433
111,Q111F,18,21,0,1,39,-1.372132265,-0.99896506,-1.185548663
111,Q111L,52,58,2,3,110,-1.338273998,-1.141198052,-1.239736025
111,Q111G,44,57,2,1,101,-1.301551191,-1.40550524,-1.353528216
111,Q111P,39,38,2,0,77,-1.185045622,-1.590029667,-1.387537644
111,Q111A,28,41,1,0,69,-1.314140318,-1.543033104,-1.428586711
111,Q111V,48,52,1,0,100,-1.473363652,-1.702256438,-1.587810045
112,E112I,14,15,27,10,29,0.199964503,-0.133663634,0.033150434
112,E112N,15,12,9,24,27,-0.217230305,0.252846913,0.017808304
112,E112K,21,25,33,17,46,0.089308785,-0.114760417,-0.012725816
112,E112S,74,68,46,44,142,-0.253310453,-0.200058588,-0.226684521
112,E112_,26,38,43,8,64,0.060467046,-0.556605911,-0.248069433
112,E112R,86,89,61,35,175,-0.223193252,-0.387145231,-0.305169242
112,E112Y,17,16,18,3,33,-0.02279759,-0.62735399,-0.32507579
112,E112C,23,37,13,12,60,-0.409274073,-0.369321547,-0.38929781
112,E112H,13,18,5,7,31,-0.497071002,-0.299995056,-0.398533029
112,E112F,24,23,17,3,47,-0.196041006,-0.77711631,-0.486578658
112,E112G,70,110,32,30,180,-0.509236909,-0.464251945,-0.486744427
112,E112W,31,47,14,11,78,-0.491608106,-0.51638091,-0.503994508
112,E112L,64,66,23,12,130,-0.507132328,-0.701263008,-0.604197668
112,E112Q,28,29,5,9,57,-0.755349017,-0.461363058,-0.608356037
112,E112M,20,24,5,5,44,-0.645133537,-0.572996328,-0.609064932
112,E112T,8,14,0,7,22,-1.13180011,-0.156572913,-0.644186512
112,E112V,67,81,11,22,148,-0.864077296,-0.509393497,-0.686735396
112,E112A,44,55,7,13,99,-0.866982287,-0.551807029,-0.709394658
112,E112D,21,38,10,1,59,-0.506830839,-1.175056319,-0.840943579
112,E112P,23,24,2,2,47,-0.974192256,-0.902055047,-0.938123652
113,I113D,10,29,9,30,39,-0.372132265,0.191366638,-0.090382813
113,I113H,18,18,20,8,36,-0.016054703,-0.311894279,-0.163974491
113,I113V,33,44,27,13,77,-0.215008845,-0.443901631,-0.329455238
113,I113R,61,58,21,33,119,-0.506830839,-0.245637393,-0.376234116
113,I113W,21,33,14,8,54,-0.334343704,-0.484055244,-0.409199474
113,I113C,23,22,10,7,45,-0.39143742,-0.457602909,-0.424520165
113,I113_,29,29,11,11,58,-0.461743039,-0.38960583,-0.425674435
113,I113Q,20,24,12,1,44,-0.309341435,-1.050117582,-0.679729509
113,I113P,26,29,11,2,55,-0.439079055,-0.969001837,-0.704040446
113,I113T,24,24,3,5,48,-0.858208363,-0.609979894,-0.734094128
113,I113A,41,35,5,7,76,-0.878411749,-0.681335802,-0.779873776
113,I113S,73,67,18,7,140,-0.640537786,-0.94406419,-0.792300988
113,I113K,15,29,2,4,44,-0.946163533,-0.652177574,-0.799170553
113,I113N,19,28,4,2,47,-0.752343507,-0.902055047,-0.827199277
113,I113G,56,65,6,10,121,-1.011334064,-0.74290221,-0.877118137
113,I113E,20,20,3,1,40,-0.780796139,-1.009688925,-0.895242532
113,I113M,24,24,2,2,48,-0.983147099,-0.91100989,-0.947078494
113,I113Y,21,32,1,4,53,-1.201436038,-0.73135882,-0.966397429
113,I113F,28,33,3,0,61,-0.960403972,-1.490326754,-1.225365363
113,I113L,66,52,0,7,118,-1.845619235,-0.870392039,-1.358005637
114,R114Q,0,0,1,0,0,0.530957722,0.302064936,0.416511329
114,R114_,0,1,6,0,1,0.773995771,0.00103494,0.387515355
114,R114V,0,1,1,0,1,0.229927726,0.00103494,0.115481333
114,R114K,0,2,0,3,2,-0.247193529,0.427003672,0.089905072
114,R114D,1,0,0,0,1,-0.071102269,0.00103494,-0.035033665
114,R114E,1,4,2,1,5,-0.071102269,-0.175056319,-0.123079294
114,R114F,2,0,0,0,2,-0.247193529,-0.175056319,-0.211124924
114,R114T,3,2,1,1,5,-0.247193529,-0.175056319,-0.211124924
114,R114H,0,2,0,0,2,-0.247193529,-0.175056319,-0.211124924
114,R114W,2,5,3,0,7,-0.071102269,-0.601025051,-0.33606366
114,R114S,1,2,0,0,3,-0.372132265,-0.299995056,-0.33606366
114,R114G,2,3,0,1,5,-0.548223524,-0.175056319,-0.361639922
114,R114M,3,1,0,0,4,-0.469042278,-0.396905069,-0.432973673
114,R114C,1,3,0,0,4,-0.469042278,-0.396905069,-0.432973673
114,R114P,1,3,0,0,4,-0.469042278,-0.396905069,-0.432973673
114,R114I,4,3,0,1,7,-0.673162261,-0.299995056,-0.486578658
114,R114L,4,3,1,0,7,-0.372132265,-0.601025051,-0.486578658
114,R114A,3,2,0,0,5,-0.548223524,-0.476086315,-0.512154919
115,T115I,1,1,5,17,2,0.530957722,1.080216186,0.805586954
115,T115L,4,2,46,0,6,1.056927544,-0.543033104,0.25694722
115,T115A,4,0,6,2,4,0.376055762,0.080216186,0.228135974
115,T115N,0,1,1,0,1,0.229927726,0.00103494,0.115481333
115,T115W,1,3,3,2,4,0.133017713,0.080216186,0.10661695
115,T115D,1,1,2,0,2,0.229927726,-0.175056319,0.027435704
115,T115E,0,1,0,0,1,-0.071102269,0.00103494,-0.035033665
115,T115H,0,1,0,0,1,-0.071102269,0.00103494,-0.035033665
115,T115C,1,1,0,1,2,-0.247193529,0.125973677,-0.060609926
115,T115_,2,0,1,0,2,0.053836467,-0.175056319,-0.060609926
115,T115V,3,3,0,8,6,-0.615170314,0.411209405,-0.101980454
115,T115P,1,3,0,2,4,-0.469042278,0.080216186,-0.194413046
115,T115Q,0,2,0,0,2,-0.247193529,-0.175056319,-0.211124924
115,T115M,2,0,0,0,2,-0.247193529,-0.175056319,-0.211124924
115,T115F,0,2,0,0,2,-0.247193529,-0.175056319,-0.211124924
115,T115G,3,3,3,0,6,-0.013110323,-0.543033104,-0.278071713
115,T115R,4,4,1,2,8,-0.423284788,-0.175056319,-0.299170553
115,T115K,3,1,0,0,4,-0.469042278,-0.396905069,-0.432973673
115,T115Y,1,3,0,0,4,-0.469042278,-0.396905069,-0.432973673
115,T115S,2,7,0,3,9,-0.770072274,-0.095875073,-0.432973673
116,F116M,0,0,3,1,0,0.831987718,0.603094931,0.717541324
116,F116L,2,2,3,3,4,0.133017713,0.205154923,0.169086318
116,F116N,2,0,4,0,2,0.451776476,-0.175056319,0.138360078
116,F116_,1,0,0,0,1,-0.071102269,0.00103494,-0.035033665
116,F116P,0,1,0,0,1,-0.071102269,0.00103494,-0.035033665
116,F116Y,1,0,0,0,1,-0.071102269,0.00103494,-0.035033665
116,F116W,0,1,0,0,1,-0.071102269,0.00103494,-0.035033665
116,F116Q,0,1,0,0,1,-0.071102269,0.00103494,-0.035033665
116,F116E,1,0,0,0,1,-0.071102269,0.00103494,-0.035033665
116,F116T,2,2,0,4,4,-0.469042278,0.302064936,-0.083488671
116,F116A,2,1,2,0,3,0.10498899,-0.299995056,-0.097503033
116,F116C,1,2,1,0,3,-0.071102269,-0.299995056,-0.185548663
116,F116I,0,2,0,0,2,-0.247193529,-0.175056319,-0.211124924
116,F116V,3,1,0,1,4,-0.469042278,-0.095875073,-0.282458676
116,F116S,2,3,0,1,5,-0.548223524,-0.175056319,-0.361639922
116,F116R,3,1,0,0,4,-0.469042278,-0.396905069,-0.432973673
116,F116D,2,2,0,0,4,-0.469042278,-0.396905069,-0.432973673
116,F116K,3,2,0,0,5,-0.548223524,-0.476086315,-0.512154919
116,F116G,2,6,1,0,8,-0.423284788,-0.652177574,-0.537731181
117,S117V,0,2,3,0,2,0.354866463,-0.175056319,0.089905072
117,S117R,4,4,17,1,8,0.530957722,-0.351147578,0.089905072
117,S117Y,1,1,1,0,2,0.053836467,-0.175056319,-0.060609926
117,S117C,2,2,4,0,4,0.229927726,-0.396905069,-0.083488671
117,S117_,6,1,2,2,7,-0.196041006,-0.123903797,-0.159972401
117,S117F,2,1,0,1,3,-0.372132265,0.00103494,-0.185548663
117,S117Q,1,1,0,0,2,-0.247193529,-0.175056319,-0.211124924
117,S117N,2,0,0,0,2,-0.247193529,-0.175056319,-0.211124924
117,S117M,1,2,0,0,3,-0.372132265,-0.299995056,-0.33606366
117,S117P,3,4,2,0,7,-0.196041006,-0.601025051,-0.398533029
117,S117W,3,1,0,0,4,-0.469042278,-0.396905069,-0.432973673
117,S117A,2,3,0,0,5,-0.548223524,-0.476086315,-0.512154919
117,S117E,2,3,0,0,5,-0.548223524,-0.476086315,-0.512154919
117,S117D,2,3,0,0,5,-0.548223524,-0.476086315,-0.512154919
117,S117K,2,5,0,0,7,-0.673162261,-0.601025051,-0.637093656
117,S117G,2,6,0,0,8,-0.724314783,-0.652177574,-0.688246178
117,S117L,5,8,1,0,13,-0.615170314,-0.8440631,-0.729616707
117,S117T,5,4,0,0,9,-0.770072274,-0.697935064,-0.734003669
118,F118Q,0,0,3,0,0,0.831987718,0.302064936,0.567026327
118,F118H,1,0,1,2,1,0.229927726,0.478156195,0.35404196
118,F118L,4,1,8,2,5,0.406018985,0.00103494,0.203526963
118,F118C,1,2,4,1,3,0.326837739,0.00103494,0.16393634
118,F118_,0,3,1,2,3,-0.071102269,0.177126199,0.053011965
118,F118W,1,4,5,1,5,0.229927726,-0.175056319,0.027435704
118,F118P,2,0,0,2,2,-0.247193529,0.302064936,0.027435704
118,F118K,1,2,1,1,3,-0.071102269,0.00103494,-0.035033665
118,F118N,1,0,0,0,1,-0.071102269,0.00103494,-0.035033665
118,F118G,6,1,3,2,7,-0.071102269,-0.123903797,-0.097503033
118,F118S,3,2,1,1,5,-0.247193529,-0.175056319,-0.211124924
118,F118R,3,1,1,0,4,-0.168012282,-0.396905069,-0.282458676
118,F118E,1,3,0,1,4,-0.469042278,-0.095875073,-0.282458676
118,F118A,3,0,0,0,3,-0.372132265,-0.299995056,-0.33606366
118,F118I,2,1,0,0,3,-0.372132265,-0.299995056,-0.33606366
118,F118M,1,2,0,0,3,-0.372132265,-0.299995056,-0.33606366
118,F118Y,2,1,0,0,3,-0.372132265,-0.299995056,-0.33606366
118,F118V,2,4,2,0,6,-0.138049059,-0.543033104,-0.340541082
118,F118D,2,2,0,0,4,-0.469042278,-0.396905069,-0.432973673
118,F118T,3,2,0,0,5,-0.548223524,-0.476086315,-0.512154919
119,Q119Y,1,0,0,0,1,-0.071102269,0.00103494,-0.035033665
119,Q119T,1,0,0,0,1,-0.071102269,0.00103494,-0.035033665
119,Q119N,1,0,0,0,1,-0.071102269,0.00103494,-0.035033665
119,Q119R,1,3,1,2,4,-0.168012282,0.080216186,-0.043898048
119,Q119H,0,2,0,1,2,-0.247193529,0.125973677,-0.060609926
119,Q119I,0,2,0,0,2,-0.247193529,-0.175056319,-0.211124924
119,Q119S,0,2,0,0,2,-0.247193529,-0.175056319,-0.211124924
119,Q119_,2,3,0,2,5,-0.548223524,0.00103494,-0.273594292
119,Q119E,2,1,0,0,3,-0.372132265,-0.299995056,-0.33606366
119,Q119M,2,1,0,0,3,-0.372132265,-0.299995056,-0.33606366
119,Q119P,1,2,0,0,3,-0.372132265,-0.299995056,-0.33606366
119,Q119V,2,1,0,0,3,-0.372132265,-0.299995056,-0.33606366
119,Q119K,3,5,1,1,8,-0.423284788,-0.351147578,-0.387216183
119,Q119W,2,2,0,0,4,-0.469042278,-0.396905069,-0.432973673
119,Q119A,0,5,0,0,5,-0.548223524,-0.476086315,-0.512154919
119,Q119D,3,2,0,0,5,-0.548223524,-0.476086315,-0.512154919
119,Q119L,5,5,1,0,10,-0.510434963,-0.739327749,-0.624881356
119,Q119G,3,7,0,0,10,-0.811464959,-0.739327749,-0.775396354
120,L120C,4,2,7,3,6,0.287919673,0.059026887,0.17347328
120,L120F,2,1,1,3,3,-0.071102269,0.302064936,0.115481333
120,L120D,1,0,0,0,1,-0.071102269,0.00103494,-0.035033665
120,L120P,1,0,0,0,1,-0.071102269,0.00103494,-0.035033665
120,L120M,0,1,0,0,1,-0.071102269,0.00103494,-0.035033665
120,L120Y,0,1,0,0,1,-0.071102269,0.00103494,-0.035033665
120,L120T,0,1,0,0,1,-0.071102269,0.00103494,-0.035033665
120,L120N,0,2,0,0,2,-0.247193529,-0.175056319,-0.211124924
120,L120S,6,2,5,0,8,0.053836467,-0.652177574,-0.299170553
120,L120I,2,1,0,0,3,-0.372132265,-0.299995056,-0.33606366
120,L120V,3,3,1,0,6,-0.314140318,-0.543033104,-0.428586711
120,L120A,3,1,0,0,4,-0.469042278,-0.396905069,-0.432973673
120,L120Q,2,2,0,0,4,-0.469042278,-0.396905069,-0.432973673
120,L120H,1,3,0,0,4,-0.469042278,-0.396905069,-0.432973673
120,L120E,2,2,0,0,4,-0.469042278,-0.396905069,-0.432973673
120,L120G,3,8,0,0,11,-0.84925352,-0.77711631,-0.813184915
120,L120R,7,6,0,0,13,-0.91620031,-0.8440631,-0.880131705
121,I121W,3,3,1,34,6,-0.314140318,1.00103494,0.343447311
121,I121K,0,1,0,0,1,-0.071102269,0.00103494,-0.035033665
121,I121H,0,1,0,0,1,-0.071102269,0.00103494,-0.035033665
121,I121T,0,2,0,1,2,-0.247193529,0.125973677,-0.060609926
121,I121F,1,1,1,0,2,0.053836467,-0.175056319,-0.060609926
121,I121_,1,1,1,0,2,0.053836467,-0.175056319,-0.060609926
121,I121V,5,2,3,2,7,-0.071102269,-0.123903797,-0.097503033
121,I121R,2,7,2,4,9,-0.292951019,0.00103494,-0.14595804
121,I121C,1,3,2,0,4,0.008078977,-0.396905069,-0.194413046
121,I121D,2,0,0,0,2,-0.247193529,-0.175056319,-0.211124924
121,I121N,1,1,0,0,2,-0.247193529,-0.175056319,-0.211124924
121,I121P,2,0,0,0,2,-0.247193529,-0.175056319,-0.211124924
121,I121S,4,5,1,3,9,-0.469042278,-0.095875073,-0.282458676
121,I121M,0,3,0,0,3,-0.372132265,-0.299995056,-0.33606366
121,I121Y,2,1,0,0,3,-0.372132265,-0.299995056,-0.33606366
121,I121A,3,3,0,2,6,-0.615170314,-0.06591185,-0.340541082
121,I121G,2,4,0,1,6,-0.615170314,-0.242003109,-0.428586711
121,I121E,1,3,0,0,4,-0.469042278,-0.396905069,-0.432973673
121,I121Q,3,4,0,1,7,-0.673162261,-0.299995056,-0.486578658
121,I121L,4,6,0,0,10,-0.811464959,-0.739327749,-0.775396354
,WT,19446,23066,19713,17649,42512,-0.103819274,-0.079712107,-0.091765691